Word	Declined	0	1
acies:Nom.Sg	aciēs	ēs	ēs
acies:Abl.Pl	aciēbus	ēbus	ēs
acies:Dat.Sg	aciēī	ēī	ēs
acies:Acc.Pl	aciēs	ēs	ēs
acies:Gen.Sg	aciēī	ēī	ēs
acies:Gen.Pl	aciērum	ērum	ēs
acies:Abl.Sg	aciē	ē	em
acies:Nom.Pl	aciēs	ēs	ēs
acies:Acc.Sg	aciem	em	ēs
acies:Dat.Pl	aciēbus	ēbus	ēs
aditus:Nom.Sg	aditus	us	us
aditus:Abl.Pl	aditibus	ibus	ibus
aditus:Dat.Sg	adituī	uī	um
aditus:Acc.Pl	aditūs	ūs	us
aditus:Gen.Sg	aditūs	ūs	ūs
aditus:Gen.Pl	adituum	uum	ēs
aditus:Abl.Sg	aditū	ū	ū
aditus:Nom.Pl	aditūs	ūs	us
aditus:Acc.Sg	aditum	um	um
aditus:Dat.Pl	aditibus	ibus	ibus
adulter:Nom.Sg	adulter	NULL	NULL
adulter:Abl.Pl	adulterīs	īs	īs
adulter:Dat.Sg	adulterō	ō	ās
adulter:Acc.Pl	adulterōs	ōs	ōs
adulter:Gen.Sg	adulterī	ī	ī
adulter:Gen.Pl	adulterōrum	ōrum	ēs
adulter:Abl.Sg	adulterō	ō	ō
adulter:Nom.Pl	adulterī	ī	ī
adulter:Acc.Sg	adulterum	um	um
adulter:Dat.Pl	adulterīs	īs	ārum
adventus:Nom.Sg	adventus	us	us
adventus:Abl.Pl	adventibus	ibus	ibus
adventus:Dat.Sg	adventuī	uī	um
adventus:Acc.Pl	adventūs	ūs	us
adventus:Gen.Sg	adventūs	ūs	us
adventus:Gen.Pl	adventuum	uum	ēs
adventus:Abl.Sg	adventū	ū	ī
adventus:Nom.Pl	adventūs	ūs	us
adventus:Acc.Sg	adventum	um	um
adventus:Dat.Pl	adventibus	ibus	ibus
aedes:Nom.Sg	aedēs	ēs	ēs
aedes:Abl.Pl	aedibus	ibus	ibus
aedes:Dat.Sg	aedī	ī	ī
aedes:Acc.Pl	aedēs	ēs	ēs
aedes:Gen.Sg	aedis	is	is
aedes:Gen.Pl	aedium	ium	ium
aedes:Abl.Sg	aede	e	e
aedes:Nom.Pl	aedēs	ēs	ēs
aedes:Acc.Sg	aedem	em	em
aedes:Dat.Pl	aedibus	ibus	ibus
aer:Nom.Sg	āēr	NULL	NULL
aer:Abl.Pl	āeribus	ibus	ibus
aer:Dat.Sg	āerī	ī	ī
aer:Acc.Pl	āerēs	ēs	ēs
aer:Gen.Sg	āeris	is	is
aer:Gen.Pl	āerum	um	um
aer:Abl.Sg	āere	e	e
aer:Nom.Pl	āerēs	ēs	ēs
aer:Acc.Sg	āera	a	a
aer:Dat.Pl	āeribus	ibus	ibus
aes:Nom.Sg	aes	NULL	NULL
aes:Abl.Pl	aeribus	ibus	ibus
aes:Dat.Sg	aerī	ī	ī
aes:Acc.Pl	aera	a	a
aes:Gen.Sg	aeris	is	is
aes:Gen.Pl	aerum	um	ēs
aes:Abl.Sg	aere	e	e
aes:Nom.Pl	aera	a	a
aes:Acc.Sg	aes	NULL	NULL
aes:Dat.Pl	aeribus	ibus	ibus
aestas:Nom.Sg	aestās	NULL	NULL
aestas:Abl.Pl	aestātibus	ibus	ibus
aestas:Dat.Sg	aestātī	ī	ī
aestas:Acc.Pl	aestātēs	ēs	ēs
aestas:Gen.Sg	aestātis	is	is
aestas:Gen.Pl	aestātum	um	um
aestas:Abl.Sg	aestāte	e	e
aestas:Nom.Pl	aestātēs	ēs	ēs
aestas:Acc.Sg	aestātem	em	em
aestas:Dat.Pl	aestātibus	ibus	ibus
aestus:Nom.Sg	aestus	us	us
aestus:Abl.Pl	aestibus	ibus	ibus
aestus:Dat.Sg	aestuī	uī	um
aestus:Acc.Pl	aestūs	ūs	us
aestus:Gen.Sg	aestūs	ūs	ūs
aestus:Gen.Pl	aestuum	uum	ēs
aestus:Abl.Sg	aestū	ū	ū
aestus:Nom.Pl	aestūs	ūs	us
aestus:Acc.Sg	aestum	um	um
aestus:Dat.Pl	aestibus	ibus	ibus
aetas:Nom.Sg	aetās	NULL	NULL
aetas:Abl.Pl	aetātibus	ibus	ibus
aetas:Dat.Sg	aetātī	ī	ī
aetas:Acc.Pl	aetātēs	ēs	ēs
aetas:Gen.Sg	aetātis	is	is
aetas:Gen.Pl	aetātum	um	um
aetas:Abl.Sg	aetāte	e	e
aetas:Nom.Pl	aetātēs	ēs	ēs
aetas:Acc.Sg	aetātem	em	em
aetas:Dat.Pl	aetātibus	ibus	ibus
aevum:Nom.Sg	aevum	um	um
aevum:Abl.Pl	aevīs	īs	īs
aevum:Dat.Sg	aevō	ō	e
aevum:Acc.Pl	aeva	a	a
aevum:Gen.Sg	aevī	ī	ī
aevum:Gen.Pl	aevōrum	ōrum	ēs
aevum:Abl.Sg	aevō	ō	ō
aevum:Nom.Pl	aeva	a	a
aevum:Acc.Sg	aevum	um	um
aevum:Dat.Pl	aevīs	īs	īs
affectus:Nom.Sg	affectus	us	us
affectus:Abl.Pl	affectibus	ibus	ibus
affectus:Dat.Sg	affectuī	uī	uī
affectus:Acc.Pl	affectūs	ūs	us
affectus:Gen.Sg	affectūs	ūs	ūs
affectus:Gen.Pl	affectuum	uum	ibus
affectus:Abl.Sg	affectū	ū	ū
affectus:Nom.Pl	affectūs	ūs	us
affectus:Acc.Sg	affectum	um	um
affectus:Dat.Pl	affectibus	ibus	ibus
ager:Nom.Sg	ager	NULL	ēs
ager:Abl.Pl	agrīs	īs	īs
ager:Dat.Sg	agrō	ō	ō
ager:Acc.Pl	agrōs	ōs	ūs
ager:Gen.Sg	agrī	ī	ī
ager:Gen.Pl	agrōrum	ōrum	ēs
ager:Abl.Sg	agrō	ō	ō
ager:Nom.Pl	agrī	ī	ī
ager:Acc.Sg	agrum	um	um
ager:Dat.Pl	agrīs	īs	īs
agger:Nom.Sg	agger	NULL	NULL
agger:Abl.Pl	aggeribus	ibus	ibus
agger:Dat.Sg	aggerī	ī	ī
agger:Acc.Pl	aggerēs	ēs	ēs
agger:Gen.Sg	aggeris	is	is
agger:Gen.Pl	aggerum	um	um
agger:Abl.Sg	aggere	e	e
agger:Nom.Pl	aggerēs	ēs	ēs
agger:Acc.Sg	aggerem	em	em
agger:Dat.Pl	aggeribus	ibus	ibus
agmen:Nom.Sg	agmen	NULL	NULL
agmen:Abl.Pl	agminibus	ibus	ibus
agmen:Dat.Sg	agminī	ī	ī
agmen:Acc.Pl	agmina	a	a
agmen:Gen.Sg	agminis	is	is
agmen:Gen.Pl	agminum	um	ēs
agmen:Abl.Sg	agmine	e	e
agmen:Nom.Pl	agmina	a	a
agmen:Acc.Sg	agmen	NULL	NULL
agmen:Dat.Pl	agminibus	ibus	ibus
ala:Nom.Sg	āla	a	a
ala:Abl.Pl	ālīs	īs	īs
ala:Dat.Sg	ālae	ae	a
ala:Acc.Pl	ālās	ās	ās
ala:Gen.Sg	ālae	ae	a
ala:Gen.Pl	ālārum	ārum	ā
ala:Abl.Sg	ālā	ā	ā
ala:Nom.Pl	ālae	ae	a
ala:Acc.Sg	ālam	am	am
ala:Dat.Pl	ālīs	īs	īs
altum:Nom.Sg	altum	um	um
altum:Abl.Pl	altīs	īs	īs
altum:Dat.Sg	altō	ō	ō
altum:Acc.Pl	alta	a	a
altum:Gen.Sg	altī	ī	ī
altum:Gen.Pl	altōrum	ōrum	ēs
altum:Abl.Sg	altō	ō	em
altum:Nom.Pl	alta	a	a
altum:Acc.Sg	altum	um	um
altum:Dat.Pl	altīs	īs	īs
amica:Nom.Sg	amīca	a	a
amica:Abl.Pl	amīcīs	īs	īs
amica:Dat.Sg	amīcae	ae	a
amica:Acc.Pl	amīcās	ās	ās
amica:Gen.Sg	amīcae	ae	a
amica:Gen.Pl	amīcārum	ārum	ās
amica:Abl.Sg	amīcā	ā	ās
amica:Nom.Pl	amīcae	ae	a
amica:Acc.Sg	amīcam	am	ōrum
amica:Dat.Pl	amīcīs	īs	īs
amicus:Nom.Sg	amīcus	us	us
amicus:Abl.Pl	amīcīs	īs	īs
amicus:Dat.Sg	amīcō	ō	ō
amicus:Acc.Pl	amīcōs	ōs	ūs
amicus:Gen.Sg	amīcī	ī	ī
amicus:Gen.Pl	amīcōrum	ōrum	ōrum
amicus:Abl.Sg	amīcō	ō	ō
amicus:Nom.Pl	amīcī	ī	ī
amicus:Acc.Sg	amīcum	um	um
amicus:Dat.Pl	amīcīs	īs	īs
amnis:Nom.Sg	amnis	is	īs
amnis:Abl.Pl	amnibus	ibus	ibus
amnis:Dat.Sg	amnī	ī	ī
amnis:Acc.Pl	amnēs	ēs	ēs
amnis:Gen.Sg	amnis	is	is
amnis:Gen.Pl	amnium	ium	ium
amnis:Abl.Sg	amne	e	e
amnis:Nom.Pl	amnēs	ēs	ēs
amnis:Acc.Sg	amnem	em	em
amnis:Dat.Pl	amnibus	ibus	ibus
amor:Nom.Sg	amor	NULL	NULL
amor:Abl.Pl	amōribus	ibus	ibus
amor:Dat.Sg	amōrī	ī	ī
amor:Acc.Pl	amōrēs	ēs	ēs
amor:Gen.Sg	amōris	is	is
amor:Gen.Pl	amōrum	um	um
amor:Abl.Sg	amōre	e	e
amor:Nom.Pl	amōrēs	ēs	ēs
amor:Acc.Sg	amōrem	em	em
amor:Dat.Pl	amōribus	ibus	ibus
anima:Nom.Sg	anima	a	a
anima:Abl.Pl	animīs	īs	īs
anima:Dat.Sg	animae	ae	a
anima:Acc.Pl	animās	ās	ās
anima:Gen.Sg	animae	ae	a
anima:Gen.Pl	animārum	ārum	ā
anima:Abl.Sg	animā	ā	ā
anima:Nom.Pl	animae	ae	a
anima:Acc.Sg	animam	am	am
anima:Dat.Pl	animīs	īs	īs
animal:Nom.Sg	animal	NULL	NULL
animal:Abl.Pl	animālibus	ibus	ibus
animal:Dat.Sg	animālī	ī	ī
animal:Acc.Pl	animālia	ia	a
animal:Gen.Sg	animālis	is	īs
animal:Gen.Pl	animālium	ium	a
animal:Abl.Sg	animālī	ī	ī
animal:Nom.Pl	animālia	ia	a
animal:Acc.Sg	animal	NULL	NULL
animal:Dat.Pl	animālibus	ibus	ibus
animus:Nom.Sg	animus	us	us
animus:Abl.Pl	animīs	īs	īs
animus:Dat.Sg	animō	ō	ō
animus:Acc.Pl	animōs	ōs	ōs
animus:Gen.Sg	animī	ī	ī
animus:Gen.Pl	animōrum	ōrum	ēs
animus:Abl.Sg	animō	ō	ō
animus:Nom.Pl	animī	ī	ī
animus:Acc.Sg	animum	um	um
animus:Dat.Pl	animīs	īs	īs
annus:Nom.Sg	annus	us	us
annus:Abl.Pl	annīs	īs	īs
annus:Dat.Sg	annō	ō	ō
annus:Acc.Pl	annōs	ōs	ōs
annus:Gen.Sg	annī	ī	ī
annus:Gen.Pl	annōrum	ōrum	ēs
annus:Abl.Sg	annō	ō	ō
annus:Nom.Pl	annī	ī	ī
annus:Acc.Sg	annum	um	um
annus:Dat.Pl	annīs	īs	īs
aqua:Nom.Sg	aqua	a	a
aqua:Abl.Pl	aquīs	īs	īs
aqua:Dat.Sg	aquae	ae	e
aqua:Acc.Pl	aquās	ās	ās
aqua:Gen.Sg	aquae	ae	e
aqua:Gen.Pl	aquārum	ārum	ās
aqua:Abl.Sg	aquā	ā	ās
aqua:Nom.Pl	aquae	ae	a
aqua:Acc.Sg	aquam	am	ōrum
aqua:Dat.Pl	aquīs	īs	īs
ara:Nom.Sg	āra	a	a
ara:Abl.Pl	ārīs	īs	īs
ara:Dat.Sg	ārae	ae	a
ara:Acc.Pl	ārās	ās	ās
ara:Gen.Sg	ārae	ae	a
ara:Gen.Pl	ārārum	ārum	ās
ara:Abl.Sg	ārā	ā	ā
ara:Nom.Pl	ārae	ae	a
ara:Acc.Sg	āram	am	ēs
ara:Dat.Pl	ārīs	īs	īs
arbiter:Nom.Sg	arbiter	NULL	ēs
arbiter:Abl.Pl	arbitrīs	īs	īs
arbiter:Dat.Sg	arbitrō	ō	ō
arbiter:Acc.Pl	arbitrōs	ōs	ūs
arbiter:Gen.Sg	arbitrī	ī	ī
arbiter:Gen.Pl	arbitrōrum	ōrum	ōrum
arbiter:Abl.Sg	arbitrō	ō	ō
arbiter:Nom.Pl	arbitrī	ī	ī
arbiter:Acc.Sg	arbitrum	um	um
arbiter:Dat.Pl	arbitrīs	īs	īs
arbitrium:Nom.Sg	arbitrium	um	um
arbitrium:Abl.Pl	arbitriīs	īs	īs
arbitrium:Dat.Sg	arbitriō	ō	ō
arbitrium:Acc.Pl	arbitria	a	a
arbitrium:Gen.Sg	arbitriī	ī	ī
arbitrium:Gen.Pl	arbitriōrum	ōrum	ēs
arbitrium:Abl.Sg	arbitriō	ō	em
arbitrium:Nom.Pl	arbitria	a	a
arbitrium:Acc.Sg	arbitrium	um	um
arbitrium:Dat.Pl	arbitriīs	īs	īs
arbor:Nom.Sg	arbor	NULL	NULL
arbor:Abl.Pl	arboribus	ibus	ibus
arbor:Dat.Sg	arborī	ī	ī
arbor:Acc.Pl	arborēs	ēs	ēs
arbor:Gen.Sg	arboris	is	is
arbor:Gen.Pl	arborum	um	ēs
arbor:Abl.Sg	arbore	e	e
arbor:Nom.Pl	arborēs	ēs	ēs
arbor:Acc.Sg	arborem	em	em
arbor:Dat.Pl	arboribus	ibus	ibus
arcus:Nom.Sg	arcus	us	us
arcus:Abl.Pl	arcubus	ubus	ibus
arcus:Dat.Sg	arcuī	uī	um
arcus:Acc.Pl	arcūs	ūs	us
arcus:Gen.Sg	arcūs	ūs	ūs
arcus:Gen.Pl	arcuum	uum	ēs
arcus:Abl.Sg	arcū	ū	ū
arcus:Nom.Pl	arcūs	ūs	us
arcus:Acc.Sg	arcum	um	um
arcus:Dat.Pl	arcubus	ubus	ibus
arena:Nom.Sg	arēna	a	a
arena:Abl.Pl	arēnīs	īs	īs
arena:Dat.Sg	arēnae	ae	a
arena:Acc.Pl	arēnās	ās	ās
arena:Gen.Sg	arēnae	ae	a
arena:Gen.Pl	arēnārum	ārum	ās
arena:Abl.Sg	arēnā	ā	ās
arena:Nom.Pl	arēnae	ae	a
arena:Acc.Sg	arēnam	am	ōrum
arena:Dat.Pl	arēnīs	īs	īs
argentum:Nom.Sg	argentum	um	um
argentum:Abl.Pl	argentīs	īs	īs
argentum:Dat.Sg	argentō	ō	ō
argentum:Acc.Pl	argenta	a	a
argentum:Gen.Sg	argentī	ī	ī
argentum:Gen.Pl	argentōrum	ōrum	ēs
argentum:Abl.Sg	argentō	ō	em
argentum:Nom.Pl	argenta	a	a
argentum:Acc.Sg	argentum	um	um
argentum:Dat.Pl	argentīs	īs	īs
arma:Nom.Sg	N/AN/A	N/A	N/A
arma:Abl.Pl	armīs	īs	īs
arma:Dat.Sg	N/AN/A	N/A	a
arma:Acc.Pl	arma	a	a
arma:Gen.Sg	N/AN/A	N/A	N/A
arma:Gen.Pl	armōrum	ōrum	ēs
arma:Abl.Sg	N/AN/A	N/A	N/A
arma:Nom.Pl	arma	a	a
arma:Acc.Sg	N/AN/A	N/A	N/A
arma:Dat.Pl	armīs	īs	īs
armentum:Nom.Sg	armentum	um	um
armentum:Abl.Pl	armentīs	īs	īs
armentum:Dat.Sg	armentō	ō	ō
armentum:Acc.Pl	armenta	a	a
armentum:Gen.Sg	armentī	ī	ī
armentum:Gen.Pl	armentōrum	ōrum	ōrum
armentum:Abl.Sg	armentō	ō	em
armentum:Nom.Pl	armenta	a	a
armentum:Acc.Sg	armentum	um	um
armentum:Dat.Pl	armentīs	īs	īs
ars:Nom.Sg	ars	NULL	NULL
ars:Abl.Pl	artibus	ibus	ibus
ars:Dat.Sg	artī	ī	ī
ars:Acc.Pl	artēs	ēs	ēs
ars:Gen.Sg	artis	is	is
ars:Gen.Pl	artium	ium	ium
ars:Abl.Sg	arte	e	e
ars:Nom.Pl	artēs	ēs	ēs
ars:Acc.Sg	artem	em	em
ars:Dat.Pl	artibus	ibus	ibus
artifex:Nom.Sg	artifex	NULL	NULL
artifex:Abl.Pl	artificibus	ibus	ibus
artifex:Dat.Sg	artificī	ī	ī
artifex:Acc.Pl	artificēs	ēs	ēs
artifex:Gen.Sg	artificis	is	is
artifex:Gen.Pl	artificum	um	um
artifex:Abl.Sg	artifice	e	e
artifex:Nom.Pl	artificēs	ēs	ēs
artifex:Acc.Sg	artificem	em	em
artifex:Dat.Pl	artificibus	ibus	ibus
artus:Nom.Sg	artus	us	us
artus:Abl.Pl	artubus	ubus	ibus
artus:Dat.Sg	artuī	uī	um
artus:Acc.Pl	artūs	ūs	us
artus:Gen.Sg	artūs	ūs	ūs
artus:Gen.Pl	artuum	uum	ēs
artus:Abl.Sg	artū	ū	ū
artus:Nom.Pl	artūs	ūs	us
artus:Acc.Sg	artum	um	um
artus:Dat.Pl	artubus	ubus	ibus
arvum:Nom.Sg	arvum	um	um
arvum:Abl.Pl	arvīs	īs	īs
arvum:Dat.Sg	arvō	ō	e
arvum:Acc.Pl	arva	a	a
arvum:Gen.Sg	arvī	ī	ī
arvum:Gen.Pl	arvōrum	ōrum	ēs
arvum:Abl.Sg	arvō	ō	ō
arvum:Nom.Pl	arva	a	a
arvum:Acc.Sg	arvum	um	um
arvum:Dat.Pl	arvīs	īs	īs
arx:Nom.Sg	arx	NULL	NULL
arx:Abl.Pl	arcibus	ibus	ibus
arx:Dat.Sg	arcī	ī	ī
arx:Acc.Pl	arcēs	ēs	ēs
arx:Gen.Sg	arcis	is	is
arx:Gen.Pl	arcium	um	a
arx:Abl.Sg	arce	e	e
arx:Nom.Pl	arcēs	ēs	ēs
arx:Acc.Sg	arcem	em	em
arx:Dat.Pl	arcibus	ibus	ibus
aspectus:Nom.Sg	aspectus	us	us
aspectus:Abl.Pl	aspectibus	ibus	ibus
aspectus:Dat.Sg	aspectuī	uī	uī
aspectus:Acc.Pl	aspectūs	ūs	us
aspectus:Gen.Sg	aspectūs	ūs	ūs
aspectus:Gen.Pl	aspectuum	uum	uī
aspectus:Abl.Sg	aspectū	ū	ū
aspectus:Nom.Pl	aspectūs	ūs	us
aspectus:Acc.Sg	aspectum	um	um
aspectus:Dat.Pl	aspectibus	ibus	ibus
astrum:Nom.Sg	astrum	um	um
astrum:Abl.Pl	astrīs	īs	ium
astrum:Dat.Sg	astrō	ō	e
astrum:Acc.Pl	astra	a	ēs
astrum:Gen.Sg	astrī	ī	ēbus
astrum:Gen.Pl	astrōrum	ōrum	ōrum
astrum:Abl.Sg	astrō	ō	ō
astrum:Nom.Pl	astra	a	ēs
astrum:Acc.Sg	astrum	um	um
astrum:Dat.Pl	astrīs	īs	a
auctor:Nom.Sg	auctor	NULL	NULL
auctor:Abl.Pl	auctōribus	ibus	ibus
auctor:Dat.Sg	auctōrī	ī	ī
auctor:Acc.Pl	auctōrēs	ēs	ēs
auctor:Gen.Sg	auctōris	is	is
auctor:Gen.Pl	auctōrum	um	um
auctor:Abl.Sg	auctōre	e	e
auctor:Nom.Pl	auctōrēs	ēs	ēs
auctor:Acc.Sg	auctōrem	em	em
auctor:Dat.Pl	auctōribus	ibus	ibus
aura:Nom.Sg	aura	a	a
aura:Abl.Pl	aurīs	īs	īs
aura:Dat.Sg	aurae	ae	ae
aura:Acc.Pl	aurās	ās	ās
aura:Gen.Sg	aurae	ae	ae
aura:Gen.Pl	aurārum	ārum	ā
aura:Abl.Sg	aurā	ā	ā
aura:Nom.Pl	aurae	ae	a
aura:Acc.Sg	auram	am	am
aura:Dat.Pl	aurīs	īs	īs
auris:Nom.Sg	auris	is	īs
auris:Abl.Pl	auribus	ibus	ibus
auris:Dat.Sg	aurī	ī	ī
auris:Acc.Pl	aurēs	ēs	ēs
auris:Gen.Sg	auris	is	is
auris:Gen.Pl	aurium	ium	ium
auris:Abl.Sg	aure	e	e
auris:Nom.Pl	aurēs	ēs	ēs
auris:Acc.Sg	aurem	em	em
auris:Dat.Pl	auribus	ibus	ibus
aurum:Nom.Sg	aurum	um	um
aurum:Abl.Pl	aurīs	īs	īs
aurum:Dat.Sg	aurō	ō	ō
aurum:Acc.Pl	aura	a	a
aurum:Gen.Sg	aurī	ī	ī
aurum:Gen.Pl	aurōrum	ōrum	ēs
aurum:Abl.Sg	aurō	ō	ō
aurum:Nom.Pl	aura	a	a
aurum:Acc.Sg	aurum	um	um
aurum:Dat.Pl	aurīs	īs	īs
auxilium:Nom.Sg	auxilium	um	um
auxilium:Abl.Pl	auxiliīs	īs	īs
auxilium:Dat.Sg	auxiliō	ō	e
auxilium:Acc.Pl	auxilia	a	a
auxilium:Gen.Sg	auxiliī	ī	ī
auxilium:Gen.Pl	auxiliōrum	ōrum	ēs
auxilium:Abl.Sg	auxiliō	ō	ō
auxilium:Nom.Pl	auxilia	a	a
auxilium:Acc.Sg	auxilium	um	um
auxilium:Dat.Pl	auxiliīs	īs	īs
avis:Nom.Sg	avis	is	īs
avis:Abl.Pl	avibus	ibus	ibus
avis:Dat.Sg	avī	ī	ī
avis:Acc.Pl	avēs	ēs	ēs
avis:Gen.Sg	avis	is	is
avis:Gen.Pl	avium	ium	a
avis:Abl.Sg	ave	e	e
avis:Nom.Pl	avēs	ēs	ēs
avis:Acc.Sg	avem	em	em
avis:Dat.Pl	avibus	ibus	ibus
avus:Nom.Sg	avus	us	us
avus:Abl.Pl	avīs	īs	īs
avus:Dat.Sg	avō	ō	e
avus:Acc.Pl	avōs	ōs	ōs
avus:Gen.Sg	avī	ī	ī
avus:Gen.Pl	avōrum	ōrum	ōrum
avus:Abl.Sg	avō	ō	ō
avus:Nom.Pl	avī	ī	ī
avus:Acc.Sg	avum	um	um
avus:Dat.Pl	avīs	īs	īs
axis:Nom.Sg	axis	is	īs
axis:Abl.Pl	axibus	ibus	ibus
axis:Dat.Sg	axī	ī	ī
axis:Acc.Pl	axēs	ēs	ēs
axis:Gen.Sg	axis	is	is
axis:Gen.Pl	axium	ium	ium
axis:Abl.Sg	axe	e	e
axis:Nom.Pl	axēs	ēs	ēs
axis:Acc.Sg	axem	em	em
axis:Dat.Pl	axibus	ibus	ibus
bellua:Nom.Sg	bellua	a	a
bellua:Abl.Pl	belluīs	īs	īs
bellua:Dat.Sg	belluae	ae	es
bellua:Acc.Pl	belluās	ās	ās
bellua:Gen.Sg	belluae	ae	ae
bellua:Gen.Pl	belluārum	ārum	ās
bellua:Abl.Sg	belluā	ā	ās
bellua:Nom.Pl	belluae	ae	N/A
bellua:Acc.Sg	belluam	am	ās
bellua:Dat.Pl	belluīs	īs	īs
bellum:Nom.Sg	bellum	um	um
bellum:Abl.Pl	bellīs	īs	īs
bellum:Dat.Sg	bellō	ō	ō
bellum:Acc.Pl	bella	a	a
bellum:Gen.Sg	bellī	ī	ī
bellum:Gen.Pl	bellōrum	ōrum	ēs
bellum:Abl.Sg	bellō	ō	ō
bellum:Nom.Pl	bella	a	a
bellum:Acc.Sg	bellum	um	um
bellum:Dat.Pl	bellīs	īs	īs
bonum:Nom.Sg	bonum	um	um
bonum:Abl.Pl	bonīs	īs	īs
bonum:Dat.Sg	bonō	ō	ō
bonum:Acc.Pl	bona	a	a
bonum:Gen.Sg	bonī	ī	ī
bonum:Gen.Pl	bonōrum	ōrum	ēs
bonum:Abl.Sg	bonō	ō	ō
bonum:Nom.Pl	bona	a	a
bonum:Acc.Sg	bonum	um	um
bonum:Dat.Pl	bonīs	īs	īs
bos:Nom.Sg	bōs	NULL	ē
bos:Abl.Pl	bōbus	NULL	ēs
bos:Dat.Sg	bovī	ī	ium
bos:Acc.Pl	bovēs	ēs	ēs
bos:Gen.Sg	bovis	is	ēs
bos:Gen.Pl	boum	NULL	uum
bos:Abl.Sg	bove	e	ēs
bos:Nom.Pl	bovēs	ēs	ēs
bos:Acc.Sg	bovem	em	ēs
bos:Dat.Pl	bōbus	NULL	ēs
brachium:Nom.Sg	brachium	um	um
brachium:Abl.Pl	brachiīs	īs	īs
brachium:Dat.Sg	brachiō	ō	ō
brachium:Acc.Pl	brachia	a	a
brachium:Gen.Sg	brachiī	ī	ī
brachium:Gen.Pl	brachiōrum	ōrum	ēs
brachium:Abl.Sg	brachiō	ō	em
brachium:Nom.Pl	brachia	a	a
brachium:Acc.Sg	brachium	um	um
brachium:Dat.Pl	brachiīs	īs	īs
caedes:Nom.Sg	caedēs	ēs	ēs
caedes:Abl.Pl	caedibus	ibus	ibus
caedes:Dat.Sg	caedī	ī	ī
caedes:Acc.Pl	caedēs	ēs	ēs
caedes:Gen.Sg	caedis	is	is
caedes:Gen.Pl	caedium	ium	ēbus
caedes:Abl.Sg	caede	e	e
caedes:Nom.Pl	caedēs	ēs	ēs
caedes:Acc.Sg	caedem	em	em
caedes:Dat.Pl	caedibus	ibus	ibus
caelum:Nom.Sg	caelum	um	um
caelum:Abl.Pl	caelīs	īs	īs
caelum:Dat.Sg	caelō	ō	ō
caelum:Acc.Pl	caela	a	a
caelum:Gen.Sg	caelī	ī	ī
caelum:Gen.Pl	caelōrum	ōrum	ēs
caelum:Abl.Sg	caelō	ō	ō
caelum:Nom.Pl	caela	a	a
caelum:Acc.Sg	caelum	um	um
caelum:Dat.Pl	caelīs	īs	īs
calor:Nom.Sg	calor	NULL	NULL
calor:Abl.Pl	calōribus	ibus	ibus
calor:Dat.Sg	calōrī	ī	ī
calor:Acc.Pl	calōrēs	ēs	ēs
calor:Gen.Sg	calōris	is	is
calor:Gen.Pl	calōrum	um	um
calor:Abl.Sg	calōre	e	e
calor:Nom.Pl	calōrēs	ēs	ēs
calor:Acc.Sg	calōrem	em	em
calor:Dat.Pl	calōribus	ibus	ibus
campus:Nom.Sg	campus	us	us
campus:Abl.Pl	campīs	īs	a
campus:Dat.Sg	campō	ō	ō
campus:Acc.Pl	campōs	ōs	ūs
campus:Gen.Sg	campī	ī	ī
campus:Gen.Pl	campōrum	ōrum	ēs
campus:Abl.Sg	campō	ō	ō
campus:Nom.Pl	campī	ī	ī
campus:Acc.Sg	campum	um	um
campus:Dat.Pl	campīs	īs	a
canis:Nom.Sg	canis	is	īs
canis:Abl.Pl	canibus	ibus	ibus
canis:Dat.Sg	canī	ī	ī
canis:Acc.Pl	canēs	ēs	ēs
canis:Gen.Sg	canis	is	is
canis:Gen.Pl	canum	um	um
canis:Abl.Sg	cane	e	e
canis:Nom.Pl	canēs	ēs	ēs
canis:Acc.Sg	canem	em	em
canis:Dat.Pl	canibus	ibus	ibus
cantus:Nom.Sg	cantus	us	us
cantus:Abl.Pl	cantibus	ibus	ibus
cantus:Dat.Sg	cantuī	uī	um
cantus:Acc.Pl	cantūs	ūs	us
cantus:Gen.Sg	cantūs	ūs	ūs
cantus:Gen.Pl	cantuum	uum	ēs
cantus:Abl.Sg	cantū	ū	ū
cantus:Nom.Pl	cantūs	ūs	us
cantus:Acc.Sg	cantum	um	um
cantus:Dat.Pl	cantibus	ibus	ibus
capillus:Nom.Sg	capillus	us	us
capillus:Abl.Pl	capillīs	īs	īs
capillus:Dat.Sg	capillō	ō	e
capillus:Acc.Pl	capillōs	ōs	ūs
capillus:Gen.Sg	capillī	ī	ī
capillus:Gen.Pl	capillōrum	ōrum	ēs
capillus:Abl.Sg	capillō	ō	ō
capillus:Nom.Pl	capillī	ī	ī
capillus:Acc.Sg	capillum	um	um
capillus:Dat.Pl	capillīs	īs	īs
caput:Nom.Sg	caput	NULL	NULL
caput:Abl.Pl	capitibus	ibus	ibus
caput:Dat.Sg	capitī	ī	ī
caput:Acc.Pl	capita	a	a
caput:Gen.Sg	capitis	is	is
caput:Gen.Pl	capitum	um	ēs
caput:Abl.Sg	capite	e	e
caput:Nom.Pl	capita	a	a
caput:Acc.Sg	caput	NULL	NULL
caput:Dat.Pl	capitibus	ibus	ibus
carcer:Nom.Sg	carcer	NULL	NULL
carcer:Abl.Pl	carceribus	ibus	ibus
carcer:Dat.Sg	carcerī	ī	ī
carcer:Acc.Pl	carcerēs	ēs	ēs
carcer:Gen.Sg	carceris	is	is
carcer:Gen.Pl	carcerum	um	um
carcer:Abl.Sg	carcere	e	e
carcer:Nom.Pl	carcerēs	ēs	ēs
carcer:Acc.Sg	carcerem	em	em
carcer:Dat.Pl	carceribus	ibus	ibus
carmen:Nom.Sg	carmen	NULL	NULL
carmen:Abl.Pl	carminibus	ibus	ibus
carmen:Dat.Sg	carminī	ī	ī
carmen:Acc.Pl	carmina	a	a
carmen:Gen.Sg	carminis	is	is
carmen:Gen.Pl	carminum	um	ēs
carmen:Abl.Sg	carmine	e	e
carmen:Nom.Pl	carmina	a	a
carmen:Acc.Sg	carmen	NULL	NULL
carmen:Dat.Pl	carminibus	ibus	ibus
castra:Nom.Sg	N/AN/A	N/A	N/A
castra:Abl.Pl	castrīs	īs	ium
castra:Dat.Sg	N/AN/A	N/A	a
castra:Acc.Pl	castra	a	ēs
castra:Gen.Sg	N/AN/A	N/A	N/A
castra:Gen.Pl	castrōrum	ōrum	ōrum
castra:Abl.Sg	N/AN/A	N/A	N/A
castra:Nom.Pl	castra	a	ēs
castra:Acc.Sg	N/AN/A	N/A	N/A
castra:Dat.Pl	castrīs	īs	a
catena:Nom.Sg	catēna	a	a
catena:Abl.Pl	catēnīs	īs	īs
catena:Dat.Sg	catēnae	ae	ae
catena:Acc.Pl	catēnās	ās	ās
catena:Gen.Sg	catēnae	ae	a
catena:Gen.Pl	catēnārum	ārum	ā
catena:Abl.Sg	catēnā	ā	ā
catena:Nom.Pl	catēnae	ae	a
catena:Acc.Sg	catēnam	am	am
catena:Dat.Pl	catēnīs	īs	īs
cena:Nom.Sg	cēna	a	a
cena:Abl.Pl	cēnīs	īs	īs
cena:Dat.Sg	cēnae	ae	ae
cena:Acc.Pl	cēnās	ās	ās
cena:Gen.Sg	cēnae	ae	a
cena:Gen.Pl	cēnārum	ārum	ārum
cena:Abl.Sg	cēnā	ā	ā
cena:Nom.Pl	cēnae	ae	a
cena:Acc.Sg	cēnam	am	am
cena:Dat.Pl	cēnīs	īs	īs
certamen:Nom.Sg	certāmen	NULL	NULL
certamen:Abl.Pl	certāminibus	ibus	ibus
certamen:Dat.Sg	certāminī	ī	ū
certamen:Acc.Pl	certāmina	a	a
certamen:Gen.Sg	certāminis	is	is
certamen:Gen.Pl	certāminum	um	um
certamen:Abl.Sg	certāmine	e	e
certamen:Nom.Pl	certāmina	a	a
certamen:Acc.Sg	certāmen	NULL	NULL
certamen:Dat.Pl	certāminibus	ibus	ibus
cervix:Nom.Sg	cervīx	NULL	NULL
cervix:Abl.Pl	cervīcibus	ibus	ibus
cervix:Dat.Sg	cervīcī	ī	ī
cervix:Acc.Pl	cervīcēs	ēs	ēs
cervix:Gen.Sg	cervīcis	is	is
cervix:Gen.Pl	cervīcum	um	ēs
cervix:Abl.Sg	cervīce	e	e
cervix:Nom.Pl	cervīcēs	ēs	ēs
cervix:Acc.Sg	cervīcem	em	em
cervix:Dat.Pl	cervīcibus	ibus	ibus
cibus:Nom.Sg	cibus	us	us
cibus:Abl.Pl	cibīs	īs	īs
cibus:Dat.Sg	cibō	ō	ō
cibus:Acc.Pl	cibōs	ōs	ōs
cibus:Gen.Sg	cibī	ī	ī
cibus:Gen.Pl	cibōrum	ōrum	ēs
cibus:Abl.Sg	cibō	ō	ō
cibus:Nom.Pl	cibī	ī	ī
cibus:Acc.Sg	cibum	um	um
cibus:Dat.Pl	cibīs	īs	īs
cinis:Nom.Sg	cinis	NULL	NULL
cinis:Abl.Pl	cineribus	ibus	ibus
cinis:Dat.Sg	cinerī	ī	ī
cinis:Acc.Pl	cinerēs	ēs	ēs
cinis:Gen.Sg	cineris	is	is
cinis:Gen.Pl	cinerum	um	um
cinis:Abl.Sg	cinere	e	e
cinis:Nom.Pl	cinerēs	ēs	ēs
cinis:Acc.Sg	cinerem	em	em
cinis:Dat.Pl	cineribus	ibus	ibus
civis:Nom.Sg	cīvis	is	īs
civis:Abl.Pl	cīvibus	ibus	ibus
civis:Dat.Sg	cīvī	ī	ī
civis:Acc.Pl	cīvēs	ēs	ēs
civis:Gen.Sg	cīvis	is	is
civis:Gen.Pl	cīvium	ium	ium
civis:Abl.Sg	cīve	e	e
civis:Nom.Pl	cīvēs	ēs	ēs
civis:Acc.Sg	cīvem	em	em
civis:Dat.Pl	cīvibus	ibus	ibus
clades:Nom.Sg	clādes	es	e
clades:Abl.Pl	clādibus	ibus	ibus
clades:Dat.Sg	clādī	ī	ī
clades:Acc.Pl	clādēs	ēs	ēs
clades:Gen.Sg	clādis	is	is
clades:Gen.Pl	clādium	ium	ium
clades:Abl.Sg	clāde	e	e
clades:Nom.Pl	clādēs	ēs	ēs
clades:Acc.Sg	clādem	em	em
clades:Dat.Pl	clādibus	ibus	ibus
clamor:Nom.Sg	clāmor	NULL	NULL
clamor:Abl.Pl	clāmōribus	ibus	ibus
clamor:Dat.Sg	clāmōrī	ī	ī
clamor:Acc.Pl	clāmōrēs	ēs	ēs
clamor:Gen.Sg	clāmōris	is	is
clamor:Gen.Pl	clāmōrum	um	um
clamor:Abl.Sg	clāmōre	e	e
clamor:Nom.Pl	clāmōrēs	ēs	ēs
clamor:Acc.Sg	clāmōrem	em	em
clamor:Dat.Pl	clāmōribus	ibus	ibus
classis:Nom.Sg	classis	is	a
classis:Abl.Pl	classibus	ibus	ibus
classis:Dat.Sg	classī	ī	ī
classis:Acc.Pl	classēs	ēs	ēs
classis:Gen.Sg	classis	is	ae
classis:Gen.Pl	classium	ium	ium
classis:Abl.Sg	classe	e	e
classis:Nom.Pl	classēs	ēs	ēs
classis:Acc.Sg	classem	em	em
classis:Dat.Pl	classibus	ibus	ibus
cliens:Nom.Sg	cliēns	NULL	NULL
cliens:Abl.Pl	clientibus	ibus	ibus
cliens:Dat.Sg	clientī	ī	ī
cliens:Acc.Pl	clientēs	ēs	ēs
cliens:Gen.Sg	clientis	is	is
cliens:Gen.Pl	clientium	ium	a
cliens:Abl.Sg	cliente	e	e
cliens:Nom.Pl	clientēs	ēs	ēs
cliens:Acc.Sg	clientem	em	em
cliens:Dat.Pl	clientibus	ibus	ibus
coetus:Nom.Sg	coetus	us	us
coetus:Abl.Pl	coetibus	ibus	ibus
coetus:Dat.Sg	coetuī	uī	um
coetus:Acc.Pl	coetūs	ūs	us
coetus:Gen.Sg	coetūs	ūs	ūs
coetus:Gen.Pl	coetuum	uum	ēs
coetus:Abl.Sg	coetū	ū	ū
coetus:Nom.Pl	coetūs	ūs	us
coetus:Acc.Sg	coetum	um	um
coetus:Dat.Pl	coetibus	ibus	ibus
cohors:Nom.Sg	cohors	NULL	NULL
cohors:Abl.Pl	cohortibus	ibus	ibus
cohors:Dat.Sg	cohortī	ī	ī
cohors:Acc.Pl	cohortēs	ēs	ēs
cohors:Gen.Sg	cohortis	is	is
cohors:Gen.Pl	cohortum	um	ēs
cohors:Abl.Sg	cohorte	e	e
cohors:Nom.Pl	cohortēs	ēs	ēs
cohors:Acc.Sg	cohortem	em	em
cohors:Dat.Pl	cohortibus	ibus	ibus
collis:Nom.Sg	collis	is	īs
collis:Abl.Pl	collibus	ibus	ibus
collis:Dat.Sg	collī	ī	ī
collis:Acc.Pl	collēs	ēs	ēs
collis:Gen.Sg	collis	is	is
collis:Gen.Pl	collium	ium	ēbus
collis:Abl.Sg	colle	e	e
collis:Nom.Pl	collēs	ēs	ēs
collis:Acc.Sg	collem	em	em
collis:Dat.Pl	collibus	ibus	ibus
collum:Nom.Sg	collum	um	um
collum:Abl.Pl	collīs	īs	īs
collum:Dat.Sg	collō	ō	ō
collum:Acc.Pl	colla	a	a
collum:Gen.Sg	collī	ī	ī
collum:Gen.Pl	collōrum	ōrum	ēs
collum:Abl.Sg	collō	ō	ō
collum:Nom.Pl	colla	a	a
collum:Acc.Sg	collum	um	um
collum:Dat.Pl	collīs	īs	īs
color:Nom.Sg	color	NULL	NULL
color:Abl.Pl	colōribus	ibus	ibus
color:Dat.Sg	colōrī	ī	ī
color:Acc.Pl	colōrēs	ēs	ēs
color:Gen.Sg	colōris	is	is
color:Gen.Pl	colōrum	um	um
color:Abl.Sg	colōre	e	e
color:Nom.Pl	colōrēs	ēs	ēs
color:Acc.Sg	colōrem	em	em
color:Dat.Pl	colōribus	ibus	ibus
coma:Nom.Sg	coma	a	a
coma:Abl.Pl	comīs	īs	īs
coma:Dat.Sg	comae	ae	ae
coma:Acc.Pl	comās	ās	am
coma:Gen.Sg	comae	ae	a
coma:Gen.Pl	comārum	ārum	am
coma:Abl.Sg	comā	ā	ā
coma:Nom.Pl	comae	ae	a
coma:Acc.Sg	comam	am	am
coma:Dat.Pl	comīs	īs	īs
comes:Nom.Sg	comes	NULL	NULL
comes:Abl.Pl	comitibus	ibus	ibus
comes:Dat.Sg	comitī	ī	ī
comes:Acc.Pl	comitēs	ēs	ēs
comes:Gen.Sg	comitis	is	is
comes:Gen.Pl	comitum	um	um
comes:Abl.Sg	comite	e	e
comes:Nom.Pl	comitēs	ēs	ēs
comes:Acc.Sg	comitem	em	em
comes:Dat.Pl	comitibus	ibus	ibus
concilium:Nom.Sg	concilium	um	um
concilium:Abl.Pl	conciliīs	īs	a
concilium:Dat.Sg	conciliō	ō	e
concilium:Acc.Pl	concilia	a	a
concilium:Gen.Sg	conciliī	ī	ī
concilium:Gen.Pl	conciliōrum	ōrum	ēs
concilium:Abl.Sg	conciliō	ō	em
concilium:Nom.Pl	concilia	a	a
concilium:Acc.Sg	concilium	um	um
concilium:Dat.Pl	conciliīs	īs	a
coniux:Nom.Sg	coniūx	NULL	NULL
coniux:Abl.Pl	coniugibus	ibus	ibus
coniux:Dat.Sg	coniugī	ī	ī
coniux:Acc.Pl	coniugēs	ēs	ēs
coniux:Gen.Sg	coniugis	is	is
coniux:Gen.Pl	coniugum	um	um
coniux:Abl.Sg	coniuge	e	e
coniux:Nom.Pl	coniugēs	ēs	ēs
coniux:Acc.Sg	coniugem	em	em
coniux:Dat.Pl	coniugibus	ibus	ibus
consul:Nom.Sg	cōnsul	NULL	NULL
consul:Abl.Pl	cōnsulibus	ibus	ibus
consul:Dat.Sg	cōnsulī	ī	ī
consul:Acc.Pl	cōnsulēs	ēs	ēs
consul:Gen.Sg	cōnsulis	is	is
consul:Gen.Pl	cōnsulum	um	um
consul:Abl.Sg	cōnsule	e	e
consul:Nom.Pl	cōnsulēs	ēs	ēs
consul:Acc.Sg	cōnsulem	em	em
consul:Dat.Pl	cōnsulibus	ibus	ibus
convivium:Nom.Sg	convīvium	um	um
convivium:Abl.Pl	convīviīs	īs	a
convivium:Dat.Sg	convīviō	ō	ō
convivium:Acc.Pl	convīvia	a	a
convivium:Gen.Sg	convīviī	ī	ī
convivium:Gen.Pl	convīviōrum	ōrum	ēs
convivium:Abl.Sg	convīviō	ō	em
convivium:Nom.Pl	convīvia	a	a
convivium:Acc.Sg	convīvium	um	um
convivium:Dat.Pl	convīviīs	īs	a
copia:Nom.Sg	cōpia	a	a
copia:Abl.Pl	cōpiīs	īs	īs
copia:Dat.Sg	cōpiae	ae	es
copia:Acc.Pl	cōpiās	ās	am
copia:Gen.Sg	cōpiae	ae	ae
copia:Gen.Pl	cōpiārum	ārum	am
copia:Abl.Sg	cōpiā	ā	ā
copia:Nom.Pl	cōpiae	ae	N/A
copia:Acc.Sg	cōpiam	am	am
copia:Dat.Pl	cōpiīs	īs	īs
cor:Nom.Sg	cor	NULL	NULL
cor:Abl.Pl	cordibus	ibus	ibus
cor:Dat.Sg	cordī	ī	ī
cor:Acc.Pl	corda	a	a
cor:Gen.Sg	cordis	is	is
cor:Gen.Pl	cordium	ium	ēbus
cor:Abl.Sg	corde	e	e
cor:Nom.Pl	corda	a	a
cor:Acc.Sg	cor	NULL	NULL
cor:Dat.Pl	cordibus	ibus	ibus
cornu:Nom.Sg	cornū	ū	ū
cornu:Abl.Pl	cornibus	ibus	ibus
cornu:Dat.Sg	cornū	ū	ū
cornu:Acc.Pl	cornua	ua	ēs
cornu:Gen.Sg	cornūs	ūs	ūs
cornu:Gen.Pl	cornuum	uum	ēs
cornu:Abl.Sg	cornū	ū	ū
cornu:Nom.Pl	cornua	ua	ēs
cornu:Acc.Sg	cornū	ū	um
cornu:Dat.Pl	cornibus	ibus	ibus
corona:Nom.Sg	corōna	a	a
corona:Abl.Pl	corōnīs	īs	īs
corona:Dat.Sg	corōnae	ae	ae
corona:Acc.Pl	corōnās	ās	ās
corona:Gen.Sg	corōnae	ae	a
corona:Gen.Pl	corōnārum	ārum	ā
corona:Abl.Sg	corōnā	ā	ā
corona:Nom.Pl	corōnae	ae	a
corona:Acc.Sg	corōnam	am	am
corona:Dat.Pl	corōnīs	īs	īs
corpus:Nom.Sg	corpus	NULL	NULL
corpus:Abl.Pl	corporibus	ibus	ibus
corpus:Dat.Sg	corporī	ī	ī
corpus:Acc.Pl	corpora	a	a
corpus:Gen.Sg	corporis	is	is
corpus:Gen.Pl	corporum	um	um
corpus:Abl.Sg	corpore	e	e
corpus:Nom.Pl	corpora	a	a
corpus:Acc.Sg	corpus	NULL	NULL
corpus:Dat.Pl	corporibus	ibus	ibus
crimen:Nom.Sg	crīmen	NULL	NULL
crimen:Abl.Pl	crīminibus	ibus	ibus
crimen:Dat.Sg	crīminī	ī	ī
crimen:Acc.Pl	crīmina	a	a
crimen:Gen.Sg	crīminis	is	is
crimen:Gen.Pl	crīminum	um	um
crimen:Abl.Sg	crīmine	e	e
crimen:Nom.Pl	crīmina	a	a
crimen:Acc.Sg	crīmen	NULL	NULL
crimen:Dat.Pl	crīminibus	ibus	ibus
crinis:Nom.Sg	crīnis	is	īs
crinis:Abl.Pl	crīnibus	ibus	ibus
crinis:Dat.Sg	crīnī	ī	ī
crinis:Acc.Pl	crīnēs	ēs	ēs
crinis:Gen.Sg	crīnis	is	is
crinis:Gen.Pl	crīnium	ium	a
crinis:Abl.Sg	crīne	e	e
crinis:Nom.Pl	crīnēs	ēs	ēs
crinis:Acc.Sg	crīnem	em	em
crinis:Dat.Pl	crīnibus	ibus	ibus
cruor:Nom.Sg	cruor	NULL	NULL
cruor:Abl.Pl	cruōribus	ibus	ibus
cruor:Dat.Sg	cruōrī	ī	ī
cruor:Acc.Pl	cruōrēs	ēs	ēs
cruor:Gen.Sg	cruōris	is	is
cruor:Gen.Pl	cruōrum	um	um
cruor:Abl.Sg	cruōre	e	e
cruor:Nom.Pl	cruōrēs	ēs	ēs
cruor:Acc.Sg	cruōrem	em	em
cruor:Dat.Pl	cruōribus	ibus	ibus
cubile:Nom.Sg	cubīle	e	e
cubile:Abl.Pl	cubīlibus	ibus	ibus
cubile:Dat.Sg	cubīlī	ī	ī
cubile:Acc.Pl	cubīlia	ia	a
cubile:Gen.Sg	cubīlis	is	is
cubile:Gen.Pl	cubīlium	ium	a
cubile:Abl.Sg	cubīlī	ī	ī
cubile:Nom.Pl	cubīlia	ia	a
cubile:Acc.Sg	cubīle	e	e
cubile:Dat.Pl	cubīlibus	ibus	ibus
culpa:Nom.Sg	culpa	a	a
culpa:Abl.Pl	culpīs	īs	īs
culpa:Dat.Sg	culpae	ae	a
culpa:Acc.Pl	culpās	ās	ās
culpa:Gen.Sg	culpae	ae	a
culpa:Gen.Pl	culpārum	ārum	am
culpa:Abl.Sg	culpā	ā	ās
culpa:Nom.Pl	culpae	ae	a
culpa:Acc.Sg	culpam	am	am
culpa:Dat.Pl	culpīs	īs	īs
cultus:Nom.Sg	cultus	us	us
cultus:Abl.Pl	cultibus	ibus	ibus
cultus:Dat.Sg	cultuī	uī	um
cultus:Acc.Pl	cultūs	ūs	us
cultus:Gen.Sg	cultūs	ūs	ūs
cultus:Gen.Pl	cultuum	uum	ēs
cultus:Abl.Sg	cultū	ū	ū
cultus:Nom.Pl	cultūs	ūs	us
cultus:Acc.Sg	cultum	um	um
cultus:Dat.Pl	cultibus	ibus	ibus
cupido:Nom.Sg	cupīdō	NULL	NULL
cupido:Abl.Pl	cupīdinibus	ibus	ibus
cupido:Dat.Sg	cupīdinī	ī	ī
cupido:Acc.Pl	cupīdinēs	ēs	ēs
cupido:Gen.Sg	cupīdinis	is	is
cupido:Gen.Pl	cupīdinum	um	um
cupido:Abl.Sg	cupīdine	e	e
cupido:Nom.Pl	cupīdinēs	ēs	ēs
cupido:Acc.Sg	cupīdinem	em	em
cupido:Dat.Pl	cupīdinibus	ibus	ibus
cura:Nom.Sg	cūra	a	a
cura:Abl.Pl	cūrīs	īs	īs
cura:Dat.Sg	cūrae	ae	ae
cura:Acc.Pl	cūrās	ās	ās
cura:Gen.Sg	cūrae	ae	a
cura:Gen.Pl	cūrārum	ārum	am
cura:Abl.Sg	cūrā	ā	ā
cura:Nom.Pl	cūrae	ae	a
cura:Acc.Sg	cūram	am	am
cura:Dat.Pl	cūrīs	īs	īs
currus:Nom.Sg	currus	us	us
currus:Abl.Pl	curribus	ibus	ibus
currus:Dat.Sg	curruī	uī	um
currus:Acc.Pl	currūs	ūs	us
currus:Gen.Sg	currūs	ūs	ūs
currus:Gen.Pl	curruum	uum	ēs
currus:Abl.Sg	currū	ū	ū
currus:Nom.Pl	currūs	ūs	us
currus:Acc.Sg	currum	um	um
currus:Dat.Pl	curribus	ibus	ibus
cursus:Nom.Sg	cursus	us	us
cursus:Abl.Pl	cursibus	ibus	ibus
cursus:Dat.Sg	cursuī	uī	um
cursus:Acc.Pl	cursūs	ūs	us
cursus:Gen.Sg	cursūs	ūs	ūs
cursus:Gen.Pl	cursuum	uum	ēs
cursus:Abl.Sg	cursū	ū	ū
cursus:Nom.Pl	cursūs	ūs	us
cursus:Acc.Sg	cursum	um	um
cursus:Dat.Pl	cursibus	ibus	ibus
custodia:Nom.Sg	custōdia	a	a
custodia:Abl.Pl	custōdiīs	īs	īs
custodia:Dat.Sg	custōdiae	ae	ae
custodia:Acc.Pl	custōdiās	ās	ās
custodia:Gen.Sg	custōdiae	ae	ae
custodia:Gen.Pl	custōdiārum	ārum	ās
custodia:Abl.Sg	custōdiā	ā	ās
custodia:Nom.Pl	custōdiae	ae	a
custodia:Acc.Sg	custōdiam	am	ās
custodia:Dat.Pl	custōdiīs	īs	īs
custos:Nom.Sg	custōs	NULL	NULL
custos:Abl.Pl	custōdibus	ibus	ibus
custos:Dat.Sg	custōdī	ī	ī
custos:Acc.Pl	custōdēs	ēs	ēs
custos:Gen.Sg	custōdis	is	is
custos:Gen.Pl	custōdum	um	um
custos:Abl.Sg	custōde	e	e
custos:Nom.Pl	custōdēs	ēs	ēs
custos:Acc.Sg	custōdem	em	em
custos:Dat.Pl	custōdibus	ibus	ibus
damnum:Nom.Sg	damnum	um	um
damnum:Abl.Pl	damnīs	īs	a
damnum:Dat.Sg	damnō	ō	ō
damnum:Acc.Pl	damna	a	a
damnum:Gen.Sg	damnī	ī	ī
damnum:Gen.Pl	damnōrum	ōrum	ēs
damnum:Abl.Sg	damnō	ō	ō
damnum:Nom.Pl	damna	a	a
damnum:Acc.Sg	damnum	um	um
damnum:Dat.Pl	damnīs	īs	a
dea:Nom.Sg	dea	a	a
dea:Abl.Pl	deābus	ābus	am
dea:Dat.Sg	deae	ae	ae
dea:Acc.Pl	deās	ās	ās
dea:Gen.Sg	deae	ae	a
dea:Gen.Pl	deārum	ārum	ās
dea:Abl.Sg	deā	ā	ā
dea:Nom.Pl	deae	ae	a
dea:Acc.Sg	deam	am	am
dea:Dat.Pl	deābus	ābus	am
decus:Nom.Sg	decus	NULL	NULL
decus:Abl.Pl	decoribus	ibus	ibus
decus:Dat.Sg	decorī	ī	ī
decus:Acc.Pl	decora	a	a
decus:Gen.Sg	decoris	is	is
decus:Gen.Pl	decorum	um	um
decus:Abl.Sg	decore	e	e
decus:Nom.Pl	decora	a	a
decus:Acc.Sg	decus	NULL	NULL
decus:Dat.Pl	decoribus	ibus	ibus
delicia:Nom.Sg	dēlicia	a	a
delicia:Abl.Pl	dēliciīs	īs	īs
delicia:Dat.Sg	dēliciae	ae	e
delicia:Acc.Pl	dēliciās	ās	ās
delicia:Gen.Sg	dēliciae	ae	e
delicia:Gen.Pl	dēliciārum	ārum	ās
delicia:Abl.Sg	dēliciā	ā	ās
delicia:Nom.Pl	dēliciae	ae	a
delicia:Acc.Sg	dēliciam	am	ēs
delicia:Dat.Pl	dēliciīs	īs	īs
dens:Nom.Sg	dēns	NULL	NULL
dens:Abl.Pl	dentibus	ibus	ibus
dens:Dat.Sg	dentī	ī	ī
dens:Acc.Pl	dentēs	ēs	ēs
dens:Gen.Sg	dentis	is	is
dens:Gen.Pl	dentium	ium	a
dens:Abl.Sg	dente	e	e
dens:Nom.Pl	dentēs	ēs	ēs
dens:Acc.Sg	dentem	em	em
dens:Dat.Pl	dentibus	ibus	ibus
deus:Nom.Sg	deus	us	ū
deus:Abl.Pl	dīs	īs	ēs
deus:Dat.Sg	deō	ō	ō
deus:Acc.Pl	deōs	ōs	ōs
deus:Gen.Sg	deī	ī	ī
deus:Gen.Pl	deōrum	ōrum	ēs
deus:Abl.Sg	deō	ō	ō
deus:Nom.Pl	dī	ī	ēs
deus:Acc.Sg	deum	um	ēs
deus:Dat.Pl	dīs	īs	ium
dictum:Nom.Sg	dictum	um	um
dictum:Abl.Pl	dictīs	īs	a
dictum:Dat.Sg	dictō	ō	ō
dictum:Acc.Pl	dicta	a	a
dictum:Gen.Sg	dictī	ī	ī
dictum:Gen.Pl	dictōrum	ōrum	ōrum
dictum:Abl.Sg	dictō	ō	ō
dictum:Nom.Pl	dicta	a	a
dictum:Acc.Sg	dictum	um	um
dictum:Dat.Pl	dictīs	īs	a
dies:Nom.Sg	diēs	ēs	ēs
dies:Abl.Pl	diēbus	ēbus	ēs
dies:Dat.Sg	diēī	ēī	ēs
dies:Acc.Pl	diēs	ēs	ēs
dies:Gen.Sg	diēī	ēī	ēs
dies:Gen.Pl	diērum	ērum	ēs
dies:Abl.Sg	diē	ē	em
dies:Nom.Pl	diēs	ēs	ēs
dies:Acc.Sg	diem	em	ēs
dies:Dat.Pl	diēbus	ēbus	ēs
digitus:Nom.Sg	digitus	us	us
digitus:Abl.Pl	digitīs	īs	īs
digitus:Dat.Sg	digitō	ō	e
digitus:Acc.Pl	digitōs	ōs	ē
digitus:Gen.Sg	digitī	ī	ī
digitus:Gen.Pl	digitōrum	ōrum	ēs
digitus:Abl.Sg	digitō	ō	ō
digitus:Nom.Pl	digitī	ī	ī
digitus:Acc.Sg	digitum	um	um
digitus:Dat.Pl	digitīs	īs	īs
discrimen:Nom.Sg	discrīmen	NULL	NULL
discrimen:Abl.Pl	discrīminibus	ibus	ibus
discrimen:Dat.Sg	discrīminī	ī	ī
discrimen:Acc.Pl	discrīmina	a	a
discrimen:Gen.Sg	discrīminis	is	is
discrimen:Gen.Pl	discrīminum	um	um
discrimen:Abl.Sg	discrīmine	e	e
discrimen:Nom.Pl	discrīmina	a	a
discrimen:Acc.Sg	discrīmen	NULL	NULL
discrimen:Dat.Pl	discrīminibus	ibus	ibus
divitiae:Nom.Sg	N/AN/A	N/A	N/A
divitiae:Abl.Pl	dīvitiīs	īs	īs
divitiae:Dat.Sg	N/AN/A	N/A	a
divitiae:Acc.Pl	dīvitiās	ās	ās
divitiae:Gen.Sg	N/AN/A	N/A	N/A
divitiae:Gen.Pl	dīvitiārum	ārum	ās
divitiae:Abl.Sg	N/AN/A	N/A	N/A
divitiae:Nom.Pl	dīvitiae	ae	a
divitiae:Acc.Sg	N/AN/A	N/A	N/A
divitiae:Dat.Pl	dīvitiīs	īs	īs
dolor:Nom.Sg	dolor	NULL	NULL
dolor:Abl.Pl	dolōribus	ibus	ibus
dolor:Dat.Sg	dolōrī	ī	ī
dolor:Acc.Pl	dolōrēs	ēs	ēs
dolor:Gen.Sg	dolōris	is	is
dolor:Gen.Pl	dolōrum	um	um
dolor:Abl.Sg	dolōre	e	e
dolor:Nom.Pl	dolōrēs	ēs	ēs
dolor:Acc.Sg	dolōrem	em	em
dolor:Dat.Pl	dolōribus	ibus	ibus
dolus:Nom.Sg	dolus	us	us
dolus:Abl.Pl	dolīs	īs	īs
dolus:Dat.Sg	dolō	ō	e
dolus:Acc.Pl	dolōs	ōs	ōs
dolus:Gen.Sg	dolī	ī	ī
dolus:Gen.Pl	dolōrum	ōrum	ēs
dolus:Abl.Sg	dolō	ō	ō
dolus:Nom.Pl	dolī	ī	ī
dolus:Acc.Sg	dolum	um	um
dolus:Dat.Pl	dolīs	īs	īs
domina:Nom.Sg	domina	a	a
domina:Abl.Pl	dominīs	īs	īs
domina:Dat.Sg	dominae	ae	ae
domina:Acc.Pl	dominās	ās	ās
domina:Gen.Sg	dominae	ae	ae
domina:Gen.Pl	dominārum	ārum	ā
domina:Abl.Sg	dominā	ā	ā
domina:Nom.Pl	dominae	ae	a
domina:Acc.Sg	dominam	am	am
domina:Dat.Pl	dominīs	īs	īs
dominus:Nom.Sg	dominus	us	us
dominus:Abl.Pl	dominīs	īs	īs
dominus:Dat.Sg	dominō	ō	ō
dominus:Acc.Pl	dominōs	ōs	ōs
dominus:Gen.Sg	dominī	ī	ī
dominus:Gen.Pl	dominōrum	ōrum	ōrum
dominus:Abl.Sg	dominō	ō	ō
dominus:Nom.Pl	dominī	ī	ī
dominus:Acc.Sg	dominum	um	um
dominus:Dat.Pl	dominīs	īs	īs
domus:Nom.Sg	domus	us	us
domus:Abl.Pl	domibus	ibus	ibus
domus:Dat.Sg	domuī	uī	uī
domus:Acc.Pl	domūs	ūs	us
domus:Gen.Sg	domūs	ūs	ūs
domus:Gen.Pl	domuum	uum	ēs
domus:Abl.Sg	domū	ū	ū
domus:Nom.Pl	domūs	ūs	us
domus:Acc.Sg	domum	um	um
domus:Dat.Pl	domibus	ibus	ibus
donum:Nom.Sg	dōnum	um	um
donum:Abl.Pl	dōnīs	īs	īs
donum:Dat.Sg	dōnō	ō	ō
donum:Acc.Pl	dōna	a	a
donum:Gen.Sg	dōnī	ī	ī
donum:Gen.Pl	dōnōrum	ōrum	ēs
donum:Abl.Sg	dōnō	ō	ō
donum:Nom.Pl	dōna	a	a
donum:Acc.Sg	dōnum	um	um
donum:Dat.Pl	dōnīs	īs	īs
dux:Nom.Sg	dux	NULL	NULL
dux:Abl.Pl	ducibus	ibus	ibus
dux:Dat.Sg	ducī	ī	ī
dux:Acc.Pl	ducēs	ēs	ēs
dux:Gen.Sg	ducis	is	is
dux:Gen.Pl	ducum	um	um
dux:Abl.Sg	duce	e	e
dux:Nom.Pl	ducēs	ēs	ēs
dux:Acc.Sg	ducem	em	em
dux:Dat.Pl	ducibus	ibus	ibus
effigies:Nom.Sg	effigiēs	ēs	ēs
effigies:Abl.Pl	effigiēbus	ēbus	ēs
effigies:Dat.Sg	effigiēī	ēī	ēs
effigies:Acc.Pl	effigiēs	ēs	ēs
effigies:Gen.Sg	effigiēī	ēī	ēs
effigies:Gen.Pl	effigiērum	ērum	ēs
effigies:Abl.Sg	effigiē	ē	ō
effigies:Nom.Pl	effigiēs	ēs	ēs
effigies:Acc.Sg	effigiem	em	ēs
effigies:Dat.Pl	effigiēbus	ēbus	ēs
epulae:Nom.Sg	N/AN/A	N/A	N/A
epulae:Abl.Pl	epulīs	īs	īs
epulae:Dat.Sg	N/AN/A	N/A	a
epulae:Acc.Pl	epulās	ās	ās
epulae:Gen.Sg	N/AN/A	N/A	N/A
epulae:Gen.Pl	epulārum	ārum	ā
epulae:Abl.Sg	N/AN/A	N/A	N/A
epulae:Nom.Pl	epulae	ae	a
epulae:Acc.Sg	N/AN/A	N/A	N/A
epulae:Dat.Pl	epulīs	īs	īs
eques:Nom.Sg	eques	NULL	NULL
eques:Abl.Pl	equitibus	ibus	ibus
eques:Dat.Sg	equitī	ī	ī
eques:Acc.Pl	equitēs	ēs	ēs
eques:Gen.Sg	equitis	is	is
eques:Gen.Pl	equitum	um	um
eques:Abl.Sg	equite	e	e
eques:Nom.Pl	equitēs	ēs	ēs
eques:Acc.Sg	equitem	em	em
eques:Dat.Pl	equitibus	ibus	ibus
equus:Nom.Sg	equus	us	us
equus:Abl.Pl	equīs	īs	īs
equus:Dat.Sg	equō	ō	ō
equus:Acc.Pl	equōs	ōs	ūs
equus:Gen.Sg	equī	ī	ī
equus:Gen.Pl	equōrum	ōrum	ēs
equus:Abl.Sg	equō	ō	ō
equus:Nom.Pl	equī	ī	ī
equus:Acc.Sg	equum	um	um
equus:Dat.Pl	equīs	īs	īs
error:Nom.Sg	error	NULL	NULL
error:Abl.Pl	errōribus	ibus	ibus
error:Dat.Sg	errōrī	ī	ī
error:Acc.Pl	errōrēs	ēs	ēs
error:Gen.Sg	errōris	is	is
error:Gen.Pl	errōrum	um	um
error:Abl.Sg	errōre	e	e
error:Nom.Pl	errōrēs	ēs	ēs
error:Acc.Sg	errōrem	em	em
error:Dat.Pl	errōribus	ibus	ibus
exemplum:Nom.Sg	exemplum	um	um
exemplum:Abl.Pl	exemplīs	īs	īs
exemplum:Dat.Sg	exemplō	ō	ō
exemplum:Acc.Pl	exempla	a	a
exemplum:Gen.Sg	exemplī	ī	ī
exemplum:Gen.Pl	exemplōrum	ōrum	ēs
exemplum:Abl.Sg	exemplō	ō	em
exemplum:Nom.Pl	exempla	a	a
exemplum:Acc.Sg	exemplum	um	um
exemplum:Dat.Pl	exemplīs	īs	īs
exiguus:Nom.Sg	exiguus	us	us
exiguus:Abl.Pl	exiguīs	īs	īs
exiguus:Dat.Sg	exiguō	ō	ō
exiguus:Acc.Pl	exiguōs	ōs	ōs
exiguus:Gen.Sg	exiguī	ī	ī
exiguus:Gen.Pl	exiguōrum	ōrum	ēs
exiguus:Abl.Sg	exiguō	ō	ō
exiguus:Nom.Pl	exiguī	ī	ī
exiguus:Acc.Sg	exiguum	um	um
exiguus:Dat.Pl	exiguīs	īs	īs
exitium:Nom.Sg	exitium	um	um
exitium:Abl.Pl	exitiīs	īs	īs
exitium:Dat.Sg	exitiō	ō	ō
exitium:Acc.Pl	exitia	a	a
exitium:Gen.Sg	exitiī	ī	ī
exitium:Gen.Pl	exitiōrum	ōrum	ēs
exitium:Abl.Sg	exitiō	ō	ō
exitium:Nom.Pl	exitia	a	a
exitium:Acc.Sg	exitium	um	um
exitium:Dat.Pl	exitiīs	īs	īs
exitus:Nom.Sg	exitus	us	us
exitus:Abl.Pl	exitibus	ibus	ibus
exitus:Dat.Sg	exituī	uī	uī
exitus:Acc.Pl	exitūs	ūs	us
exitus:Gen.Sg	exitūs	ūs	ūs
exitus:Gen.Pl	exituum	uum	ēs
exitus:Abl.Sg	exitū	ū	ū
exitus:Nom.Pl	exitūs	ūs	us
exitus:Acc.Sg	exitum	um	um
exitus:Dat.Pl	exitibus	ibus	ibus
exsilium:Nom.Sg	exsilium	um	um
exsilium:Abl.Pl	exsiliīs	īs	īs
exsilium:Dat.Sg	exsiliō	ō	em
exsilium:Acc.Pl	exsilia	a	a
exsilium:Gen.Sg	exsiliī	ī	ī
exsilium:Gen.Pl	exsiliōrum	ōrum	ēs
exsilium:Abl.Sg	exsiliō	ō	em
exsilium:Nom.Pl	exsilia	a	a
exsilium:Acc.Sg	exsilium	um	um
exsilium:Dat.Pl	exsiliīs	īs	īs
exsul:Nom.Sg	exsul	NULL	NULL
exsul:Abl.Pl	exsulibus	ibus	ibus
exsul:Dat.Sg	exsulī	ī	ī
exsul:Acc.Pl	exsulēs	ēs	ēs
exsul:Gen.Sg	exsulis	is	is
exsul:Gen.Pl	exsulum	um	um
exsul:Abl.Sg	exsule	e	e
exsul:Nom.Pl	exsulēs	ēs	ēs
exsul:Acc.Sg	exsulem	em	em
exsul:Dat.Pl	exsulibus	ibus	ibus
fabula:Nom.Sg	fābula	a	a
fabula:Abl.Pl	fābulīs	īs	īs
fabula:Dat.Sg	fābulae	ae	a
fabula:Acc.Pl	fābulās	ās	am
fabula:Gen.Sg	fābulae	ae	a
fabula:Gen.Pl	fābulārum	ārum	ās
fabula:Abl.Sg	fābulā	ā	ā
fabula:Nom.Pl	fābulae	ae	a
fabula:Acc.Sg	fābulam	am	am
fabula:Dat.Pl	fābulīs	īs	īs
facies:Nom.Sg	faciēs	ēs	ēs
facies:Abl.Pl	faciēbus	ēbus	ēs
facies:Dat.Sg	faciēī	ēī	ēs
facies:Acc.Pl	faciēs	ēs	ēs
facies:Gen.Sg	faciēī	ēī	ēs
facies:Gen.Pl	faciērum	ērum	ēs
facies:Abl.Sg	faciē	ē	em
facies:Nom.Pl	faciēs	ēs	ēs
facies:Acc.Sg	faciem	em	ēs
facies:Dat.Pl	faciēbus	ēbus	ēs
facinus:Nom.Sg	facinus	NULL	NULL
facinus:Abl.Pl	facinoribus	ibus	ibus
facinus:Dat.Sg	facinorī	ī	ī
facinus:Acc.Pl	facinora	a	a
facinus:Gen.Sg	facinoris	is	is
facinus:Gen.Pl	facinorum	um	ēs
facinus:Abl.Sg	facinore	e	e
facinus:Nom.Pl	facinora	a	a
facinus:Acc.Sg	facinus	NULL	NULL
facinus:Dat.Pl	facinoribus	ibus	ibus
factum:Nom.Sg	factum	um	um
factum:Abl.Pl	factīs	īs	a
factum:Dat.Sg	factō	ō	ō
factum:Acc.Pl	facta	a	a
factum:Gen.Sg	factī	ī	ī
factum:Gen.Pl	factōrum	ōrum	ōrum
factum:Abl.Sg	factō	ō	ō
factum:Nom.Pl	facta	a	a
factum:Acc.Sg	factum	um	um
factum:Dat.Pl	factīs	īs	a
fama:Nom.Sg	fāma	a	a
fama:Abl.Pl	fāmīs	īs	īs
fama:Dat.Sg	fāmae	ae	a
fama:Acc.Pl	fāmās	ās	ās
fama:Gen.Sg	fāmae	ae	a
fama:Gen.Pl	fāmārum	ārum	ā
fama:Abl.Sg	fāmā	ā	ā
fama:Nom.Pl	fāmae	ae	a
fama:Acc.Sg	fāmam	am	am
fama:Dat.Pl	fāmīs	īs	īs
fames:Nom.Sg	famēs	ēs	ēs
fames:Abl.Pl	famibus	ibus	ibus
fames:Dat.Sg	famī	ī	ī
fames:Acc.Pl	famēs	ēs	ēs
fames:Gen.Sg	famis	is	is
fames:Gen.Pl	famum	um	um
fames:Abl.Sg	fame	e	e
fames:Nom.Pl	famēs	ēs	ēs
fames:Acc.Sg	famem	em	em
fames:Dat.Pl	famibus	ibus	ibus
fastigium:Nom.Sg	fastīgium	um	um
fastigium:Abl.Pl	fastīgiīs	īs	īs
fastigium:Dat.Sg	fastīgiō	ō	ō
fastigium:Acc.Pl	fastīgia	a	a
fastigium:Gen.Sg	fastīgiī	ī	ī
fastigium:Gen.Pl	fastīgiōrum	ōrum	ēs
fastigium:Abl.Sg	fastīgiō	ō	em
fastigium:Nom.Pl	fastīgia	a	a
fastigium:Acc.Sg	fastīgium	um	um
fastigium:Dat.Pl	fastīgiīs	īs	īs
fatum:Nom.Sg	fātum	um	um
fatum:Abl.Pl	fātīs	īs	īs
fatum:Dat.Sg	fātō	ō	ō
fatum:Acc.Pl	fāta	a	a
fatum:Gen.Sg	fātī	ī	ī
fatum:Gen.Pl	fātōrum	ōrum	ēs
fatum:Abl.Sg	fātō	ō	em
fatum:Nom.Pl	fāta	a	a
fatum:Acc.Sg	fātum	um	um
fatum:Dat.Pl	fātīs	īs	īs
favor:Nom.Sg	favor	NULL	NULL
favor:Abl.Pl	favōribus	ibus	ibus
favor:Dat.Sg	favōrī	ī	ī
favor:Acc.Pl	favōrēs	ēs	ēs
favor:Gen.Sg	favōris	is	is
favor:Gen.Pl	favōrum	um	um
favor:Abl.Sg	favōre	e	e
favor:Nom.Pl	favōrēs	ēs	ēs
favor:Acc.Sg	favōrem	em	em
favor:Dat.Pl	favōribus	ibus	ibus
fax:Nom.Sg	fax	NULL	NULL
fax:Abl.Pl	facibus	ibus	ibus
fax:Dat.Sg	facī	ī	ī
fax:Acc.Pl	facēs	ēs	ēs
fax:Gen.Sg	facis	is	is
fax:Gen.Pl	facum	um	um
fax:Abl.Sg	face	e	e
fax:Nom.Pl	facēs	ēs	ēs
fax:Acc.Sg	facem	em	em
fax:Dat.Pl	facibus	ibus	ibus
femina:Nom.Sg	fēmina	a	a
femina:Abl.Pl	fēminīs	īs	īs
femina:Dat.Sg	fēminae	ae	ae
femina:Acc.Pl	fēminās	ās	ās
femina:Gen.Sg	fēminae	ae	a
femina:Gen.Pl	fēminārum	ārum	ā
femina:Abl.Sg	fēminā	ā	ā
femina:Nom.Pl	fēminae	ae	a
femina:Acc.Sg	fēminam	am	am
femina:Dat.Pl	fēminīs	īs	īs
fera:Nom.Sg	fera	a	a
fera:Abl.Pl	ferīs	īs	īs
fera:Dat.Sg	ferae	ae	ae
fera:Acc.Pl	ferās	ās	ās
fera:Gen.Sg	ferae	ae	ae
fera:Gen.Pl	ferārum	ārum	ās
fera:Abl.Sg	ferā	ā	ās
fera:Nom.Pl	ferae	ae	a
fera:Acc.Sg	feram	am	am
fera:Dat.Pl	ferīs	īs	īs
ferrum:Nom.Sg	ferrum	um	um
ferrum:Abl.Pl	ferrīs	īs	īs
ferrum:Dat.Sg	ferrō	ō	ō
ferrum:Acc.Pl	ferra	a	a
ferrum:Gen.Sg	ferrī	ī	ī
ferrum:Gen.Pl	ferrōrum	ōrum	ēs
ferrum:Abl.Sg	ferrō	ō	ō
ferrum:Nom.Pl	ferra	a	a
ferrum:Acc.Sg	ferrum	um	um
ferrum:Dat.Pl	ferrīs	īs	īs
fetus:Nom.Sg	fētus	us	us
fetus:Abl.Pl	fētibus	ibus	ibus
fetus:Dat.Sg	fētuī	uī	um
fetus:Acc.Pl	fētūs	ūs	us
fetus:Gen.Sg	fētūs	ūs	ūs
fetus:Gen.Pl	fētuum	uum	ēs
fetus:Abl.Sg	fētū	ū	ū
fetus:Nom.Pl	fētūs	ūs	us
fetus:Acc.Sg	fētum	um	um
fetus:Dat.Pl	fētibus	ibus	ibus
fides:Nom.Sg	fidēs	ēs	ēs
fides:Abl.Pl	fidēbus	ēbus	ēs
fides:Dat.Sg	fideī	eī	a
fides:Acc.Pl	fidēs	ēs	ēs
fides:Gen.Sg	fideī	eī	a
fides:Gen.Pl	fidērum	ērum	ēs
fides:Abl.Sg	fidē	ē	em
fides:Nom.Pl	fidēs	ēs	ēs
fides:Acc.Sg	fidem	em	em
fides:Dat.Pl	fidēbus	ēbus	ēs
filia:Nom.Sg	fīlia	a	a
filia:Abl.Pl	fīliīs	īs	īs
filia:Dat.Sg	fīliae	ae	ae
filia:Acc.Pl	fīliās	ās	ās
filia:Gen.Sg	fīliae	ae	a
filia:Gen.Pl	fīliārum	ārum	ās
filia:Abl.Sg	fīliā	ā	ās
filia:Nom.Pl	fīliae	ae	a
filia:Acc.Sg	fīliam	am	am
filia:Dat.Pl	fīliīs	īs	īs
filius:Nom.Sg	fīlius	us	us
filius:Abl.Pl	fīliīs	īs	īs
filius:Dat.Sg	fīliō	ō	ō
filius:Acc.Pl	fīliōs	ōs	ōs
filius:Gen.Sg	fīliī	ī	ī
filius:Gen.Pl	fīliōrum	ōrum	ēs
filius:Abl.Sg	fīliō	ō	ō
filius:Nom.Pl	fīliī	ī	ī
filius:Acc.Sg	fīlium	um	um
filius:Dat.Pl	fīliīs	īs	īs
finis:Nom.Sg	fīnis	is	īs
finis:Abl.Pl	fīnibus	ibus	ibus
finis:Dat.Sg	fīnī	ī	ī
finis:Acc.Pl	fīnēs	ēs	ēs
finis:Gen.Sg	fīnis	is	is
finis:Gen.Pl	fīnium	ium	a
finis:Abl.Sg	fīne	e	e
finis:Nom.Pl	fīnēs	ēs	ēs
finis:Acc.Sg	fīnem	em	em
finis:Dat.Pl	fīnibus	ibus	ibus
flamma:Nom.Sg	flamma	a	a
flamma:Abl.Pl	flammīs	īs	a
flamma:Dat.Sg	flammae	ae	ae
flamma:Acc.Pl	flammās	ās	ās
flamma:Gen.Sg	flammae	ae	ae
flamma:Gen.Pl	flammārum	ārum	ā
flamma:Abl.Sg	flammā	ā	ā
flamma:Nom.Pl	flammae	ae	a
flamma:Acc.Sg	flammam	am	am
flamma:Dat.Pl	flammīs	īs	a
fletus:Nom.Sg	flētus	us	us
fletus:Abl.Pl	flētibus	ibus	ibus
fletus:Dat.Sg	flētuī	uī	um
fletus:Acc.Pl	flētūs	ūs	us
fletus:Gen.Sg	flētūs	ūs	ūs
fletus:Gen.Pl	flētuum	uum	ēs
fletus:Abl.Sg	flētū	ū	ū
fletus:Nom.Pl	flētūs	ūs	us
fletus:Acc.Sg	flētum	um	um
fletus:Dat.Pl	flētibus	ibus	ibus
flos:Nom.Sg	flōs	NULL	NULL
flos:Abl.Pl	flōribus	ibus	ibus
flos:Dat.Sg	flōrī	ī	ī
flos:Acc.Pl	flōrēs	ēs	ēs
flos:Gen.Sg	flōris	is	is
flos:Gen.Pl	flōrum	um	um
flos:Abl.Sg	flōre	e	e
flos:Nom.Pl	flōrēs	ēs	ēs
flos:Acc.Sg	flōrem	em	em
flos:Dat.Pl	flōribus	ibus	ibus
fluctus:Nom.Sg	fluctus	us	us
fluctus:Abl.Pl	fluctibus	ibus	ibus
fluctus:Dat.Sg	fluctuī	uī	um
fluctus:Acc.Pl	fluctūs	ūs	us
fluctus:Gen.Sg	fluctūs	ūs	ūs
fluctus:Gen.Pl	fluctuum	uum	ēs
fluctus:Abl.Sg	fluctū	ū	ū
fluctus:Nom.Pl	fluctūs	ūs	us
fluctus:Acc.Sg	fluctum	um	um
fluctus:Dat.Pl	fluctibus	ibus	ibus
flumen:Nom.Sg	flūmen	NULL	NULL
flumen:Abl.Pl	flūminibus	ibus	ibus
flumen:Dat.Sg	flūminī	ī	ī
flumen:Acc.Pl	flūmina	a	a
flumen:Gen.Sg	flūminis	is	is
flumen:Gen.Pl	flūminum	um	um
flumen:Abl.Sg	flūmine	e	e
flumen:Nom.Pl	flūmina	a	a
flumen:Acc.Sg	flūmen	NULL	NULL
flumen:Dat.Pl	flūminibus	ibus	ibus
focus:Nom.Sg	focus	us	us
focus:Abl.Pl	focīs	īs	īs
focus:Dat.Sg	focō	ō	ō
focus:Acc.Pl	focōs	ōs	ōs
focus:Gen.Sg	focī	ī	ī
focus:Gen.Pl	focōrum	ōrum	ēs
focus:Abl.Sg	focō	ō	ō
focus:Nom.Pl	focī	ī	ī
focus:Acc.Sg	focum	um	um
focus:Dat.Pl	focīs	īs	īs
foedus:Nom.Sg	foedus	NULL	NULL
foedus:Abl.Pl	foederibus	ibus	ibus
foedus:Dat.Sg	foederī	ī	ī
foedus:Acc.Pl	foedera	a	a
foedus:Gen.Sg	foederis	is	is
foedus:Gen.Pl	foederum	um	um
foedus:Abl.Sg	foedere	e	e
foedus:Nom.Pl	foedera	a	a
foedus:Acc.Sg	foedus	NULL	NULL
foedus:Dat.Pl	foederibus	ibus	ibus
fons:Nom.Sg	fōns	NULL	NULL
fons:Abl.Pl	fontibus	ibus	ibus
fons:Dat.Sg	fontī	ī	ī
fons:Acc.Pl	fontēs	ēs	ēs
fons:Gen.Sg	fontis	is	is
fons:Gen.Pl	fontium	ium	ium
fons:Abl.Sg	fonte	e	e
fons:Nom.Pl	fontēs	ēs	ēs
fons:Acc.Sg	fontem	em	em
fons:Dat.Pl	fontibus	ibus	ibus
foris:Nom.Sg	foris	is	īs
foris:Abl.Pl	foribus	ibus	ibus
foris:Dat.Sg	forī	ī	ī
foris:Acc.Pl	forēs	ēs	ēs
foris:Gen.Sg	foris	is	is
foris:Gen.Pl	forium	ium	ēbus
foris:Abl.Sg	fore	e	e
foris:Nom.Pl	forēs	ēs	ēs
foris:Acc.Sg	forem	em	em
foris:Dat.Pl	foribus	ibus	ibus
forma:Nom.Sg	fōrma	a	a
forma:Abl.Pl	fōrmīs	īs	īs
forma:Dat.Sg	fōrmae	ae	ae
forma:Acc.Pl	fōrmās	ās	am
forma:Gen.Sg	fōrmae	ae	ae
forma:Gen.Pl	fōrmārum	ārum	ās
forma:Abl.Sg	fōrmā	ā	ās
forma:Nom.Pl	fōrmae	ae	a
forma:Acc.Sg	fōrmam	am	am
forma:Dat.Pl	fōrmīs	īs	īs
formido:Nom.Sg	formīdo	NULL	NULL
formido:Abl.Pl	formīdinibus	ibus	ibus
formido:Dat.Sg	formīdinī	ī	ī
formido:Acc.Pl	formīdinēs	ēs	ēs
formido:Gen.Sg	formīdinis	is	is
formido:Gen.Pl	formīdinum	um	um
formido:Abl.Sg	formīdine	e	e
formido:Nom.Pl	formīdinēs	ēs	ēs
formido:Acc.Sg	formīdinem	em	em
formido:Dat.Pl	formīdinibus	ibus	uī
fortuna:Nom.Sg	fortūna	a	a
fortuna:Abl.Pl	fortūnīs	īs	īs
fortuna:Dat.Sg	fortūnae	ae	a
fortuna:Acc.Pl	fortūnās	ās	am
fortuna:Gen.Sg	fortūnae	ae	a
fortuna:Gen.Pl	fortūnārum	ārum	ās
fortuna:Abl.Sg	fortūnā	ā	ās
fortuna:Nom.Pl	fortūnae	ae	a
fortuna:Acc.Sg	fortūnam	am	am
fortuna:Dat.Pl	fortūnīs	īs	īs
forum:Nom.Sg	forum	um	um
forum:Abl.Pl	forīs	īs	īs
forum:Dat.Sg	forō	ō	ō
forum:Acc.Pl	fora	a	a
forum:Gen.Sg	forī	ī	ī
forum:Gen.Pl	forōrum	ōrum	ēs
forum:Abl.Sg	forō	ō	ō
forum:Nom.Pl	fora	a	a
forum:Acc.Sg	forum	um	um
forum:Dat.Pl	forīs	īs	īs
frater:Nom.Sg	frāter	NULL	em
frater:Abl.Pl	frātribus	ibus	ibus
frater:Dat.Sg	frātrī	ī	ī
frater:Acc.Pl	frātrēs	ēs	ēs
frater:Gen.Sg	frātris	is	is
frater:Gen.Pl	frātrum	um	um
frater:Abl.Sg	frātre	e	e
frater:Nom.Pl	frātrēs	ēs	ēs
frater:Acc.Sg	frātrem	em	em
frater:Dat.Pl	frātribus	ibus	ibus
fraus:Nom.Sg	fraus	NULL	NULL
fraus:Abl.Pl	fraudibus	ibus	ibus
fraus:Dat.Sg	fraudī	ī	ī
fraus:Acc.Pl	fraudēs	ēs	ēs
fraus:Gen.Sg	fraudis	is	is
fraus:Gen.Pl	fraudum	um	ēs
fraus:Abl.Sg	fraude	e	e
fraus:Nom.Pl	fraudēs	ēs	ēs
fraus:Acc.Sg	fraudem	em	em
fraus:Dat.Pl	fraudibus	ibus	ibus
fremitus:Nom.Sg	fremitus	us	us
fremitus:Abl.Pl	fremitibus	ibus	ibus
fremitus:Dat.Sg	fremituī	uī	uī
fremitus:Acc.Pl	fremitūs	ūs	us
fremitus:Gen.Sg	fremitūs	ūs	ūs
fremitus:Gen.Pl	fremituum	uum	ēs
fremitus:Abl.Sg	fremitū	ū	ū
fremitus:Nom.Pl	fremitūs	ūs	us
fremitus:Acc.Sg	fremitum	um	um
fremitus:Dat.Pl	fremitibus	ibus	ibus
frenum:Nom.Sg	frēnum	um	um
frenum:Abl.Pl	frēnīs	īs	īs
frenum:Dat.Sg	frēnō	ō	ō
frenum:Acc.Pl	frēna	a	a
frenum:Gen.Sg	frēnī	ī	ī
frenum:Gen.Pl	frēnōrum	ōrum	ēs
frenum:Abl.Sg	frēnō	ō	ō
frenum:Nom.Pl	frēna	a	a
frenum:Acc.Sg	frēnum	um	um
frenum:Dat.Pl	frēnīs	īs	īs
fretum:Nom.Sg	fretum	um	um
fretum:Abl.Pl	fretīs	īs	īs
fretum:Dat.Sg	fretō	ō	ō
fretum:Acc.Pl	freta	a	a
fretum:Gen.Sg	fretī	ī	ī
fretum:Gen.Pl	fretōrum	ōrum	ēs
fretum:Abl.Sg	fretō	ō	ō
fretum:Nom.Pl	freta	a	a
fretum:Acc.Sg	fretum	um	um
fretum:Dat.Pl	fretīs	īs	īs
frigus:Nom.Sg	frīgus	NULL	NULL
frigus:Abl.Pl	frīgoribus	ibus	ibus
frigus:Dat.Sg	frīgorī	ī	ī
frigus:Acc.Pl	frīgora	a	a
frigus:Gen.Sg	frīgoris	is	is
frigus:Gen.Pl	frīgorum	um	um
frigus:Abl.Sg	frīgore	e	e
frigus:Nom.Pl	frīgora	a	a
frigus:Acc.Sg	frīgus	NULL	NULL
frigus:Dat.Pl	frīgoribus	ibus	ibus
frons:Nom.Sg	frōns	NULL	NULL
frons:Abl.Pl	frontibus	ibus	ibus
frons:Dat.Sg	frontī	ī	ī
frons:Acc.Pl	frontēs	ēs	ēs
frons:Gen.Sg	frontis	is	is
frons:Gen.Pl	frontium	ium	ium
frons:Abl.Sg	fronte	e	e
frons:Nom.Pl	frontēs	ēs	ēs
frons:Acc.Sg	frontem	em	em
frons:Dat.Pl	frontibus	ibus	ibus
frons:Nom.Sg	frons	NULL	NULL
frons:Abl.Pl	frondibus	ibus	ibus
frons:Dat.Sg	frondī	ī	ī
frons:Acc.Pl	frondēs	ēs	ēs
frons:Gen.Sg	frondis	is	is
frons:Gen.Pl	frondium	ium	ēbus
frons:Abl.Sg	fronde	e	e
frons:Nom.Pl	frondēs	ēs	ēs
frons:Acc.Sg	frondem	em	em
frons:Dat.Pl	frondibus	ibus	ibus
fructus:Nom.Sg	fructus	us	us
fructus:Abl.Pl	fructibus	ibus	ibus
fructus:Dat.Sg	fructuī	uī	ēs
fructus:Acc.Pl	fructūs	ūs	us
fructus:Gen.Sg	fructūs	ūs	ūs
fructus:Gen.Pl	fructuum	uum	ēs
fructus:Abl.Sg	fructū	ū	ū
fructus:Nom.Pl	fructūs	ūs	us
fructus:Acc.Sg	fructum	um	um
fructus:Dat.Pl	fructibus	ibus	ibus
frumentum:Nom.Sg	frūmentum	um	um
frumentum:Abl.Pl	frūmentīs	īs	īs
frumentum:Dat.Sg	frūmentō	ō	e
frumentum:Acc.Pl	frūmenta	a	a
frumentum:Gen.Sg	frūmentī	ī	ī
frumentum:Gen.Pl	frūmentōrum	ōrum	ōrum
frumentum:Abl.Sg	frūmentō	ō	em
frumentum:Nom.Pl	frūmenta	a	a
frumentum:Acc.Sg	frūmentum	um	um
frumentum:Dat.Pl	frūmentīs	īs	īs
frux:Nom.Sg	frūx	NULL	NULL
frux:Abl.Pl	frūgibus	ibus	ibus
frux:Dat.Sg	frūgī	ī	ī
frux:Acc.Pl	frūgēs	ēs	ēs
frux:Gen.Sg	frūgis	is	is
frux:Gen.Pl	frūgum	um	ēs
frux:Abl.Sg	frūge	e	e
frux:Nom.Pl	frūgēs	ēs	ēs
frux:Acc.Sg	frūgem	em	em
frux:Dat.Pl	frūgibus	ibus	ibus
fuga:Nom.Sg	fuga	a	a
fuga:Abl.Pl	fugīs	īs	īs
fuga:Dat.Sg	fugae	ae	a
fuga:Acc.Pl	fugās	ās	am
fuga:Gen.Sg	fugae	ae	a
fuga:Gen.Pl	fugārum	ārum	am
fuga:Abl.Sg	fugā	ā	ās
fuga:Nom.Pl	fugae	ae	a
fuga:Acc.Sg	fugam	am	am
fuga:Dat.Pl	fugīs	īs	īs
fulmen:Nom.Sg	fulmen	NULL	NULL
fulmen:Abl.Pl	fulminibus	ibus	ibus
fulmen:Dat.Sg	fulminī	ī	ī
fulmen:Acc.Pl	fulmina	a	a
fulmen:Gen.Sg	fulminis	is	is
fulmen:Gen.Pl	fulminum	um	um
fulmen:Abl.Sg	fulmine	e	e
fulmen:Nom.Pl	fulmina	a	a
fulmen:Acc.Sg	fulmen	NULL	NULL
fulmen:Dat.Pl	fulminibus	ibus	ibus
funis:Nom.Sg	fūnis	is	īs
funis:Abl.Pl	fūnibus	ibus	ibus
funis:Dat.Sg	fūnī	ī	ī
funis:Acc.Pl	fūnēs	ēs	ēs
funis:Gen.Sg	fūnis	is	is
funis:Gen.Pl	fūnium	ium	ium
funis:Abl.Sg	fūne	e	e
funis:Nom.Pl	fūnēs	ēs	ēs
funis:Acc.Sg	fūnem	em	em
funis:Dat.Pl	fūnibus	ibus	ibus
funus:Nom.Sg	fūnus	NULL	NULL
funus:Abl.Pl	fūneribus	ibus	ibus
funus:Dat.Sg	fūnerī	ī	ī
funus:Acc.Pl	fūnera	a	a
funus:Gen.Sg	fūneris	is	is
funus:Gen.Pl	fūnerum	um	um
funus:Abl.Sg	fūnere	e	e
funus:Nom.Pl	fūnera	a	a
funus:Acc.Sg	fūnus	NULL	NULL
funus:Dat.Pl	fūneribus	ibus	ibus
furor:Nom.Sg	furor	NULL	NULL
furor:Abl.Pl	furōribus	ibus	ibus
furor:Dat.Sg	furōrī	ī	ī
furor:Acc.Pl	furōrēs	ēs	ēs
furor:Gen.Sg	furōris	is	is
furor:Gen.Pl	furōrum	um	um
furor:Abl.Sg	furōre	e	e
furor:Nom.Pl	furōrēs	ēs	ēs
furor:Acc.Sg	furōrem	em	em
furor:Dat.Pl	furōribus	ibus	ibus
furtum:Nom.Sg	fūrtum	um	um
furtum:Abl.Pl	fūrtīs	īs	īs
furtum:Dat.Sg	fūrtō	ō	ō
furtum:Acc.Pl	fūrta	a	a
furtum:Gen.Sg	fūrtī	ī	ī
furtum:Gen.Pl	fūrtōrum	ōrum	ōrum
furtum:Abl.Sg	fūrtō	ō	ō
furtum:Nom.Pl	fūrta	a	a
furtum:Acc.Sg	fūrtum	um	um
furtum:Dat.Pl	fūrtīs	īs	īs
gaudium:Nom.Sg	gaudium	um	um
gaudium:Abl.Pl	gaudiīs	īs	īs
gaudium:Dat.Sg	gaudiō	ō	ō
gaudium:Acc.Pl	gaudia	a	a
gaudium:Gen.Sg	gaudiī	ī	ī
gaudium:Gen.Pl	gaudiōrum	ōrum	ōrum
gaudium:Abl.Sg	gaudiō	ō	ō
gaudium:Nom.Pl	gaudia	a	a
gaudium:Acc.Sg	gaudium	um	um
gaudium:Dat.Pl	gaudiīs	īs	īs
gemitus:Nom.Sg	gemitus	us	us
gemitus:Abl.Pl	gemitibus	ibus	ibus
gemitus:Dat.Sg	gemituī	uī	um
gemitus:Acc.Pl	gemitūs	ūs	us
gemitus:Gen.Sg	gemitūs	ūs	ūs
gemitus:Gen.Pl	gemituum	uum	ēs
gemitus:Abl.Sg	gemitū	ū	ū
gemitus:Nom.Pl	gemitūs	ūs	us
gemitus:Acc.Sg	gemitum	um	um
gemitus:Dat.Pl	gemitibus	ibus	ibus
gemma:Nom.Sg	gemma	a	a
gemma:Abl.Pl	gemmīs	īs	a
gemma:Dat.Sg	gemmae	ae	ae
gemma:Acc.Pl	gemmās	ās	ās
gemma:Gen.Sg	gemmae	ae	ae
gemma:Gen.Pl	gemmārum	ārum	ās
gemma:Abl.Sg	gemmā	ā	ās
gemma:Nom.Pl	gemmae	ae	a
gemma:Acc.Sg	gemmam	am	am
gemma:Dat.Pl	gemmīs	īs	a
gens:Nom.Sg	gēns	NULL	NULL
gens:Abl.Pl	gentibus	ibus	ibus
gens:Dat.Sg	gentī	ī	ī
gens:Acc.Pl	gentēs	ēs	ēs
gens:Gen.Sg	gentis	is	is
gens:Gen.Pl	gentium	ium	ium
gens:Abl.Sg	gente	e	e
gens:Nom.Pl	gentēs	ēs	ēs
gens:Acc.Sg	gentem	em	em
gens:Dat.Pl	gentibus	ibus	ibus
genu:Nom.Sg	genū	ū	ū
genu:Abl.Pl	genibus	ibus	ibus
genu:Dat.Sg	genū	ū	ū
genu:Acc.Pl	genua	ua	ēs
genu:Gen.Sg	genūs	ūs	ūs
genu:Gen.Pl	genuum	uum	ēs
genu:Abl.Sg	genū	ū	ū
genu:Nom.Pl	genua	ua	ēs
genu:Acc.Sg	genū	ū	um
genu:Dat.Pl	genibus	ibus	ibus
genus:Nom.Sg	genus	NULL	NULL
genus:Abl.Pl	generibus	ibus	ibus
genus:Dat.Sg	generī	ī	ī
genus:Acc.Pl	genera	a	a
genus:Gen.Sg	generis	is	is
genus:Gen.Pl	generum	um	um
genus:Abl.Sg	genere	e	e
genus:Nom.Pl	genera	a	a
genus:Acc.Sg	genus	NULL	NULL
genus:Dat.Pl	generibus	ibus	ibus
gladius:Nom.Sg	gladius	us	us
gladius:Abl.Pl	gladiīs	īs	īs
gladius:Dat.Sg	gladiō	ō	ō
gladius:Acc.Pl	gladiōs	ōs	ūs
gladius:Gen.Sg	gladiī	ī	ī
gladius:Gen.Pl	gladiōrum	ōrum	ēs
gladius:Abl.Sg	gladiō	ō	ō
gladius:Nom.Pl	gladiī	ī	ī
gladius:Acc.Sg	gladium	um	um
gladius:Dat.Pl	gladiīs	īs	īs
gloria:Nom.Sg	glōria	a	a
gloria:Abl.Pl	glōriīs	īs	īs
gloria:Dat.Sg	glōriae	ae	ae
gloria:Acc.Pl	glōriās	ās	ās
gloria:Gen.Sg	glōriae	ae	a
gloria:Gen.Pl	glōriārum	ārum	ā
gloria:Abl.Sg	glōriā	ā	ā
gloria:Nom.Pl	glōriae	ae	a
gloria:Acc.Sg	glōriam	am	am
gloria:Dat.Pl	glōriīs	īs	īs
gradus:Nom.Sg	gradus	us	us
gradus:Abl.Pl	gradibus	ibus	ibus
gradus:Dat.Sg	graduī	uī	um
gradus:Acc.Pl	gradūs	ūs	us
gradus:Gen.Sg	gradūs	ūs	ūs
gradus:Gen.Pl	graduum	uum	ēs
gradus:Abl.Sg	gradū	ū	ū
gradus:Nom.Pl	gradūs	ūs	us
gradus:Acc.Sg	gradum	um	um
gradus:Dat.Pl	gradibus	ibus	ibus
gratia:Nom.Sg	grātia	a	a
gratia:Abl.Pl	grātiīs	īs	īs
gratia:Dat.Sg	grātiae	ae	a
gratia:Acc.Pl	grātiās	ās	ās
gratia:Gen.Sg	grātiae	ae	a
gratia:Gen.Pl	grātiārum	ārum	am
gratia:Abl.Sg	grātiā	ā	ā
gratia:Nom.Pl	grātiae	ae	a
gratia:Acc.Sg	grātiam	am	ēs
gratia:Dat.Pl	grātiīs	īs	īs
grex:Nom.Sg	grex	NULL	NULL
grex:Abl.Pl	gregibus	ibus	ibus
grex:Dat.Sg	gregī	ī	ī
grex:Acc.Pl	gregēs	ēs	ēs
grex:Gen.Sg	gregis	is	is
grex:Gen.Pl	gregum	um	um
grex:Abl.Sg	grege	e	e
grex:Nom.Pl	gregēs	ēs	ēs
grex:Acc.Sg	gregem	em	em
grex:Dat.Pl	gregibus	ibus	ibus
habitus:Nom.Sg	habitus	us	us
habitus:Abl.Pl	habitibus	ibus	ibus
habitus:Dat.Sg	habituī	uī	um
habitus:Acc.Pl	habitūs	ūs	us
habitus:Gen.Sg	habitūs	ūs	ūs
habitus:Gen.Pl	habituum	uum	ēs
habitus:Abl.Sg	habitū	ū	ū
habitus:Nom.Pl	habitūs	ūs	us
habitus:Acc.Sg	habitum	um	um
habitus:Dat.Pl	habitibus	ibus	ibus
hasta:Nom.Sg	hasta	a	a
hasta:Abl.Pl	hastīs	īs	īs
hasta:Dat.Sg	hastae	ae	ae
hasta:Acc.Pl	hastās	ās	ās
hasta:Gen.Sg	hastae	ae	ae
hasta:Gen.Pl	hastārum	ārum	ā
hasta:Abl.Sg	hastā	ā	ā
hasta:Nom.Pl	hastae	ae	a
hasta:Acc.Sg	hastam	am	am
hasta:Dat.Pl	hastīs	īs	īs
herba:Nom.Sg	herba	a	a
herba:Abl.Pl	herbīs	īs	īs
herba:Dat.Sg	herbae	ae	ae
herba:Acc.Pl	herbās	ās	ās
herba:Gen.Sg	herbae	ae	ae
herba:Gen.Pl	herbārum	ārum	ās
herba:Abl.Sg	herbā	ā	ā
herba:Nom.Pl	herbae	ae	a
herba:Acc.Sg	herbam	am	am
herba:Dat.Pl	herbīs	īs	īs
heres:Nom.Sg	hērēs	NULL	NULL
heres:Abl.Pl	hērēdibus	ibus	ibus
heres:Dat.Sg	hērēdī	ī	ī
heres:Acc.Pl	hērēdēs	ēs	ēs
heres:Gen.Sg	hērēdis	is	is
heres:Gen.Pl	hērēdum	um	um
heres:Abl.Sg	hērēde	e	e
heres:Nom.Pl	hērēdes	es	ēs
heres:Acc.Sg	hērēdem	em	em
heres:Dat.Pl	hērēdibus	ibus	ibus
hiems:Nom.Sg	hiems	NULL	NULL
hiems:Abl.Pl	hiemibus	ibus	ibus
hiems:Dat.Sg	hiemī	ī	ī
hiems:Acc.Pl	hiemēs	ēs	ēs
hiems:Gen.Sg	hiemis	is	is
hiems:Gen.Pl	hiemum	um	ēs
hiems:Abl.Sg	hieme	e	e
hiems:Nom.Pl	hiemēs	ēs	ēs
hiems:Acc.Sg	hiemem	em	em
hiems:Dat.Pl	hiemibus	ibus	ibus
homo:Nom.Sg	homō	NULL	NULL
homo:Abl.Pl	hominibus	ibus	ibus
homo:Dat.Sg	hominī	ī	ī
homo:Acc.Pl	hominēs	ēs	ēs
homo:Gen.Sg	hominis	is	is
homo:Gen.Pl	hominum	um	um
homo:Abl.Sg	homine	e	e
homo:Nom.Pl	hominēs	ēs	ēs
homo:Acc.Sg	hominem	em	em
homo:Dat.Pl	hominibus	ibus	ibus
honor:Nom.Sg	honor	NULL	NULL
honor:Abl.Pl	honōribus	ibus	ibus
honor:Dat.Sg	honōrī	ī	ī
honor:Acc.Pl	honōrēs	ēs	ēs
honor:Gen.Sg	honōris	is	is
honor:Gen.Pl	honōrum	um	um
honor:Abl.Sg	honōre	e	e
honor:Nom.Pl	honōrēs	ēs	ēs
honor:Acc.Sg	honōrem	em	em
honor:Dat.Pl	honōribus	ibus	ibus
hora:Nom.Sg	hōra	a	a
hora:Abl.Pl	hōrīs	īs	īs
hora:Dat.Sg	hōrae	ae	ae
hora:Acc.Pl	hōrās	ās	ās
hora:Gen.Sg	hōrae	ae	ae
hora:Gen.Pl	hōrārum	ārum	ā
hora:Abl.Sg	hōrā	ā	ā
hora:Nom.Pl	hōrae	ae	a
hora:Acc.Sg	hōram	am	am
hora:Dat.Pl	hōrīs	īs	īs
hortus:Nom.Sg	hortus	us	us
hortus:Abl.Pl	hortīs	īs	īs
hortus:Dat.Sg	hortō	ō	ō
hortus:Acc.Pl	hortōs	ōs	ūs
hortus:Gen.Sg	hortī	ī	ī
hortus:Gen.Pl	hortōrum	ōrum	ēs
hortus:Abl.Sg	hortō	ō	ō
hortus:Nom.Pl	hortī	ī	ī
hortus:Acc.Sg	hortum	um	um
hortus:Dat.Pl	hortīs	īs	īs
hospes:Nom.Sg	hospes	NULL	NULL
hospes:Abl.Pl	hospitibus	ibus	ibus
hospes:Dat.Sg	hospitī	ī	ī
hospes:Acc.Pl	hospitēs	ēs	ēs
hospes:Gen.Sg	hospitis	is	is
hospes:Gen.Pl	hospitum	um	um
hospes:Abl.Sg	hospite	e	e
hospes:Nom.Pl	hospitēs	ēs	ēs
hospes:Acc.Sg	hospitem	em	em
hospes:Dat.Pl	hospitibus	ibus	ibus
hostis:Nom.Sg	hostis	is	īs
hostis:Abl.Pl	hostibus	ibus	ibus
hostis:Dat.Sg	hostī	ī	ī
hostis:Acc.Pl	hostēs	ēs	ēs
hostis:Gen.Sg	hostis	is	is
hostis:Gen.Pl	hostium	ium	ium
hostis:Abl.Sg	hoste	e	e
hostis:Nom.Pl	hostēs	ēs	ēs
hostis:Acc.Sg	hostem	em	em
hostis:Dat.Pl	hostibus	ibus	ibus
humerus:Nom.Sg	humerus	us	us
humerus:Abl.Pl	humerīs	īs	īs
humerus:Dat.Sg	humerō	ō	ō
humerus:Acc.Pl	humerōs	ōs	ūs
humerus:Gen.Sg	humerī	ī	ī
humerus:Gen.Pl	humerōrum	ōrum	ēs
humerus:Abl.Sg	humerō	ō	em
humerus:Nom.Pl	humerī	ī	ī
humerus:Acc.Sg	humerum	um	um
humerus:Dat.Pl	humerīs	īs	īs
humor:Nom.Sg	hūmor	NULL	NULL
humor:Abl.Pl	hūmōribus	ibus	ibus
humor:Dat.Sg	hūmōrī	ī	ī
humor:Acc.Pl	hūmōrēs	ēs	ēs
humor:Gen.Sg	hūmōris	is	is
humor:Gen.Pl	hūmōrum	um	um
humor:Abl.Sg	hūmōre	e	e
humor:Nom.Pl	hūmōrēs	ēs	ēs
humor:Acc.Sg	hūmōrem	em	em
humor:Dat.Pl	hūmōribus	ibus	ibus
humus:Nom.Sg	humus	us	us
humus:Abl.Pl	humīs	īs	īs
humus:Dat.Sg	humō	ō	ō
humus:Acc.Pl	humōs	ōs	ōs
humus:Gen.Sg	humī	ī	ī
humus:Gen.Pl	humōrum	ōrum	ōrum
humus:Abl.Sg	humō	ō	ō
humus:Nom.Pl	humī	ī	ī
humus:Acc.Sg	humum	um	um
humus:Dat.Pl	humīs	īs	īs
ictus:Nom.Sg	ictus	us	us
ictus:Abl.Pl	ictibus	ibus	ibus
ictus:Dat.Sg	ictuī	uī	um
ictus:Acc.Pl	ictūs	ūs	us
ictus:Gen.Sg	ictūs	ūs	ūs
ictus:Gen.Pl	ictuum	uum	ēs
ictus:Abl.Sg	ictū	ū	ū
ictus:Nom.Pl	ictūs	ūs	us
ictus:Acc.Sg	ictum	um	um
ictus:Dat.Pl	ictibus	ibus	ibus
ignis:Nom.Sg	ignis	is	īs
ignis:Abl.Pl	ignibus	ibus	ibus
ignis:Dat.Sg	ignī	ī	ī
ignis:Acc.Pl	ignēs	ēs	ēs
ignis:Gen.Sg	ignis	is	is
ignis:Gen.Pl	ignium	ium	ium
ignis:Abl.Sg	igne	e	e
ignis:Nom.Pl	ignēs	ēs	ēs
ignis:Acc.Sg	ignem	em	em
ignis:Dat.Pl	ignibus	ibus	ibus
imago:Nom.Sg	imāgō	NULL	NULL
imago:Abl.Pl	imāginibus	ibus	ibus
imago:Dat.Sg	imāginī	ī	ī
imago:Acc.Pl	imāginēs	ēs	ēs
imago:Gen.Sg	imāginis	is	is
imago:Gen.Pl	imāginum	um	um
imago:Abl.Sg	imāgine	e	e
imago:Nom.Pl	imāginēs	ēs	ēs
imago:Acc.Sg	imāginem	em	ēs
imago:Dat.Pl	imāginibus	ibus	ibus
imber:Nom.Sg	imber	NULL	em
imber:Abl.Pl	imbribus	ibus	ibus
imber:Dat.Sg	imbrī	ī	ī
imber:Acc.Pl	imbrēs	ēs	ēs
imber:Gen.Sg	imbris	is	is
imber:Gen.Pl	imbrium	ium	ium
imber:Abl.Sg	imbre	e	e
imber:Nom.Pl	imbrēs	ēs	ēs
imber:Acc.Sg	imbrem	em	em
imber:Dat.Pl	imbribus	ibus	ibus
imperium:Nom.Sg	imperium	um	um
imperium:Abl.Pl	imperiīs	īs	īs
imperium:Dat.Sg	imperiō	ō	e
imperium:Acc.Pl	imperia	a	a
imperium:Gen.Sg	imperiī	ī	ī
imperium:Gen.Pl	imperiōrum	ōrum	ōrum
imperium:Abl.Sg	imperiō	ō	ō
imperium:Nom.Pl	imperia	a	a
imperium:Acc.Sg	imperium	um	um
imperium:Dat.Pl	imperiīs	īs	īs
impetus:Nom.Sg	impetus	us	us
impetus:Abl.Pl	impetibus	ibus	ibus
impetus:Dat.Sg	impetuī	uī	uī
impetus:Acc.Pl	impetūs	ūs	us
impetus:Gen.Sg	impetūs	ūs	ūs
impetus:Gen.Pl	impetuum	uum	ēs
impetus:Abl.Sg	impetū	ū	ū
impetus:Nom.Pl	impetūs	ūs	us
impetus:Acc.Sg	impetum	um	um
impetus:Dat.Pl	impetibus	ibus	ibus
incendium:Nom.Sg	incendium	um	um
incendium:Abl.Pl	incendiīs	īs	īs
incendium:Dat.Sg	incendiō	ō	ō
incendium:Acc.Pl	incendia	a	a
incendium:Gen.Sg	incendiī	ī	ī
incendium:Gen.Pl	incendiōrum	ōrum	ēs
incendium:Abl.Sg	incendiō	ō	ō
incendium:Nom.Pl	incendia	a	a
incendium:Acc.Sg	incendium	um	um
incendium:Dat.Pl	incendiīs	īs	īs
infans:Nom.Sg	īnfāns	NULL	NULL
infans:Abl.Pl	īnfantibus	ibus	ibus
infans:Dat.Sg	īnfantī	ī	ī
infans:Acc.Pl	īnfantēs	ēs	ēs
infans:Gen.Sg	īnfantis	is	ae
infans:Gen.Pl	īnfantium	ium	ēbus
infans:Abl.Sg	īnfante	e	e
infans:Nom.Pl	īnfantēs	ēs	ēs
infans:Acc.Sg	īnfantem	em	em
infans:Dat.Pl	īnfantibus	ibus	ibus
ingenium:Nom.Sg	ingenium	um	um
ingenium:Abl.Pl	ingeniīs	īs	īs
ingenium:Dat.Sg	ingeniō	ō	ō
ingenium:Acc.Pl	ingenia	a	a
ingenium:Gen.Sg	ingeniī	ī	ī
ingenium:Gen.Pl	ingeniōrum	ōrum	ēs
ingenium:Abl.Sg	ingeniō	ō	ō
ingenium:Nom.Pl	ingenia	a	a
ingenium:Acc.Sg	ingenium	um	um
ingenium:Dat.Pl	ingeniīs	īs	īs
iniuria:Nom.Sg	iniūria	a	a
iniuria:Abl.Pl	iniūriīs	īs	īs
iniuria:Dat.Sg	iniūriae	ae	ae
iniuria:Acc.Pl	iniūriās	ās	ās
iniuria:Gen.Sg	iniūriae	ae	ae
iniuria:Gen.Pl	iniūriārum	ārum	ā
iniuria:Abl.Sg	iniūriā	ā	ā
iniuria:Nom.Pl	iniūriae	ae	a
iniuria:Acc.Sg	iniūriam	am	ōrum
iniuria:Dat.Pl	iniūriīs	īs	īs
insidia:Nom.Sg	īnsidia	a	a
insidia:Abl.Pl	īnsidiīs	īs	īs
insidia:Dat.Sg	īnsidiae	ae	ae
insidia:Acc.Pl	īnsidiās	ās	ās
insidia:Gen.Sg	īnsidiae	ae	ae
insidia:Gen.Pl	īnsidiārum	ārum	ā
insidia:Abl.Sg	īnsidiā	ā	ā
insidia:Nom.Pl	īnsidiae	ae	a
insidia:Acc.Sg	īnsidiam	am	am
insidia:Dat.Pl	īnsidiīs	īs	īs
insula:Nom.Sg	īnsula	a	a
insula:Abl.Pl	īnsulīs	īs	īs
insula:Dat.Sg	īnsulae	ae	a
insula:Acc.Pl	īnsulās	ās	ās
insula:Gen.Sg	īnsulae	ae	a
insula:Gen.Pl	īnsulārum	ārum	ā
insula:Abl.Sg	īnsulā	ā	ā
insula:Nom.Pl	īnsulae	ae	a
insula:Acc.Sg	īnsulam	am	am
insula:Dat.Pl	īnsulīs	īs	īs
invidia:Nom.Sg	invidia	a	a
invidia:Abl.Pl	invidiīs	īs	īs
invidia:Dat.Sg	invidiae	ae	a
invidia:Acc.Pl	invidiās	ās	ās
invidia:Gen.Sg	invidiae	ae	a
invidia:Gen.Pl	invidiārum	ārum	am
invidia:Abl.Sg	invidiā	ā	ā
invidia:Nom.Pl	invidiae	ae	a
invidia:Acc.Sg	invidiam	am	ēs
invidia:Dat.Pl	invidiīs	īs	īs
ira:Nom.Sg	īra	a	a
ira:Abl.Pl	īrīs	īs	īs
ira:Dat.Sg	īrae	ae	ae
ira:Acc.Pl	īrās	ās	ās
ira:Gen.Sg	īrae	ae	ae
ira:Gen.Pl	īrārum	ārum	ā
ira:Abl.Sg	īrā	ā	ā
ira:Nom.Pl	īrae	ae	a
ira:Acc.Sg	īram	am	am
ira:Dat.Pl	īrīs	īs	īs
iter:Nom.Sg	iter	NULL	NULL
iter:Abl.Pl	itineribus	ibus	ibus
iter:Dat.Sg	itinerī	ī	ī
iter:Acc.Pl	itinera	a	a
iter:Gen.Sg	itineris	is	is
iter:Gen.Pl	itinerum	um	um
iter:Abl.Sg	itinere	e	e
iter:Nom.Pl	itinera	a	a
iter:Acc.Sg	iter	NULL	NULL
iter:Dat.Pl	itineribus	ibus	ibus
iudex:Nom.Sg	iūdex	NULL	NULL
iudex:Abl.Pl	iūdicibus	ibus	ibus
iudex:Dat.Sg	iūdicī	ī	ī
iudex:Acc.Pl	iūdicēs	ēs	ēs
iudex:Gen.Sg	iūdicis	is	is
iudex:Gen.Pl	iūdicum	um	um
iudex:Abl.Sg	iūdice	e	e
iudex:Nom.Pl	iūdicēs	ēs	ēs
iudex:Acc.Sg	iūdicem	em	em
iudex:Dat.Pl	iūdicibus	ibus	ibus
iugum:Nom.Sg	iugum	um	um
iugum:Abl.Pl	iugīs	īs	īs
iugum:Dat.Sg	iugō	ō	e
iugum:Acc.Pl	iuga	a	a
iugum:Gen.Sg	iugī	ī	ī
iugum:Gen.Pl	iugōrum	ōrum	ēs
iugum:Abl.Sg	iugō	ō	ō
iugum:Nom.Pl	iuga	a	a
iugum:Acc.Sg	iugum	um	um
iugum:Dat.Pl	iugīs	īs	īs
ius:Nom.Sg	iūs	NULL	NULL
ius:Abl.Pl	iūribus	ibus	ibus
ius:Dat.Sg	iūrī	ī	ī
ius:Acc.Pl	iūra	a	a
ius:Gen.Sg	iūris	is	is
ius:Gen.Pl	iūrum	um	um
ius:Abl.Sg	iūre	e	e
ius:Nom.Pl	iūra	a	a
ius:Acc.Sg	iūs	NULL	NULL
ius:Dat.Pl	iūribus	ibus	ibus
iuvenis:Nom.Sg	iuvenis	is	īs
iuvenis:Abl.Pl	iuvenibus	ibus	ibus
iuvenis:Dat.Sg	iuvenī	ī	ī
iuvenis:Acc.Pl	iuvenēs	ēs	ēs
iuvenis:Gen.Sg	iuvenis	is	is
iuvenis:Gen.Pl	iuvenum	um	um
iuvenis:Abl.Sg	iuvene	e	e
iuvenis:Nom.Pl	iuvenēs	ēs	ēs
iuvenis:Acc.Sg	iuvenem	em	em
iuvenis:Dat.Pl	iuvenibus	ibus	ibus
iuventa:Nom.Sg	iuventa	a	a
iuventa:Abl.Pl	iuventīs	īs	īs
iuventa:Dat.Sg	iuventae	ae	ae
iuventa:Acc.Pl	iuventās	ās	ās
iuventa:Gen.Sg	iuventae	ae	ae
iuventa:Gen.Pl	iuventārum	ārum	ās
iuventa:Abl.Sg	iuventā	ā	ā
iuventa:Nom.Pl	iuventae	ae	a
iuventa:Acc.Sg	iuventam	am	am
iuventa:Dat.Pl	iuventīs	īs	īs
iuventus:Nom.Sg	iuventūs	NULL	NULL
iuventus:Abl.Pl	iuventūtibus	ibus	ibus
iuventus:Dat.Sg	iuventūtī	ī	ī
iuventus:Acc.Pl	iuventūtēs	ēs	ēs
iuventus:Gen.Sg	iuventūtis	is	is
iuventus:Gen.Pl	iuventūtum	um	um
iuventus:Abl.Sg	iuventūte	e	e
iuventus:Nom.Pl	iuventūtēs	ēs	ēs
iuventus:Acc.Sg	iuventūtem	em	em
iuventus:Dat.Pl	iuventūtibus	ibus	ibus
labor:Nom.Sg	labor	NULL	NULL
labor:Abl.Pl	labōribus	ibus	ibus
labor:Dat.Sg	labōrī	ī	ī
labor:Acc.Pl	labōrēs	ēs	ēs
labor:Gen.Sg	labōris	is	is
labor:Gen.Pl	labōrum	um	um
labor:Abl.Sg	labōre	e	e
labor:Nom.Pl	labōrēs	ēs	ēs
labor:Acc.Sg	labōrem	em	em
labor:Dat.Pl	labōribus	ibus	ibus
lacrima:Nom.Sg	lacrima	a	a
lacrima:Abl.Pl	lacrimīs	īs	īs
lacrima:Dat.Sg	lacrimae	ae	ae
lacrima:Acc.Pl	lacrimās	ās	ās
lacrima:Gen.Sg	lacrimae	ae	ae
lacrima:Gen.Pl	lacrimārum	ārum	ā
lacrima:Abl.Sg	lacrimā	ā	ā
lacrima:Nom.Pl	lacrimae	ae	a
lacrima:Acc.Sg	lacrimam	am	am
lacrima:Dat.Pl	lacrimīs	īs	īs
lacus:Nom.Sg	lacus	us	us
lacus:Abl.Pl	lacubus	ubus	ibus
lacus:Dat.Sg	lacuī	uī	um
lacus:Acc.Pl	lacūs	ūs	us
lacus:Gen.Sg	lacūs	ūs	ūs
lacus:Gen.Pl	lacuum	uum	ēs
lacus:Abl.Sg	lacū	ū	ū
lacus:Nom.Pl	lacūs	ūs	us
lacus:Acc.Sg	lacum	um	um
lacus:Dat.Pl	lacubus	ubus	ibus
laetitia:Nom.Sg	laetitia	a	a
laetitia:Abl.Pl	laetitiīs	īs	īs
laetitia:Dat.Sg	laetitiae	ae	a
laetitia:Acc.Pl	laetitiās	ās	ās
laetitia:Gen.Sg	laetitiae	ae	a
laetitia:Gen.Pl	laetitiārum	ārum	ā
laetitia:Abl.Sg	laetitiā	ā	ā
laetitia:Nom.Pl	laetitiae	ae	a
laetitia:Acc.Sg	laetitiam	am	am
laetitia:Dat.Pl	laetitiīs	īs	īs
lapis:Nom.Sg	lapis	is	NULL
lapis:Abl.Pl	lapidibus	ibus	ibus
lapis:Dat.Sg	lapidī	ī	ī
lapis:Acc.Pl	lapidēs	ēs	ēs
lapis:Gen.Sg	lapidis	is	is
lapis:Gen.Pl	lapidum	um	um
lapis:Abl.Sg	lapide	e	e
lapis:Nom.Pl	lapidēs	ēs	ēs
lapis:Acc.Sg	lapidem	em	em
lapis:Dat.Pl	lapidibus	ibus	ibus
latebra:Nom.Sg	latēbra	a	a
latebra:Abl.Pl	latēbrīs	īs	īs
latebra:Dat.Sg	latēbrae	ae	ae
latebra:Acc.Pl	latēbrās	ās	ās
latebra:Gen.Sg	latēbrae	ae	a
latebra:Gen.Pl	latēbrārum	ārum	ā
latebra:Abl.Sg	latēbrā	ā	ā
latebra:Nom.Pl	latēbrae	ae	a
latebra:Acc.Sg	latēbram	am	ās
latebra:Dat.Pl	latēbrīs	īs	īs
latus:Nom.Sg	latus	NULL	NULL
latus:Abl.Pl	lateribus	ibus	ibus
latus:Dat.Sg	laterī	ī	ī
latus:Acc.Pl	latera	a	a
latus:Gen.Sg	lateris	is	is
latus:Gen.Pl	laterum	um	um
latus:Abl.Sg	latere	e	e
latus:Nom.Pl	latera	a	a
latus:Acc.Sg	latus	NULL	NULL
latus:Dat.Pl	lateribus	ibus	ibus
laus:Nom.Sg	laus	NULL	NULL
laus:Abl.Pl	laudibus	ibus	ibus
laus:Dat.Sg	laudī	ī	ī
laus:Acc.Pl	laudēs	ēs	ēs
laus:Gen.Sg	laudis	is	is
laus:Gen.Pl	laudum	um	um
laus:Abl.Sg	laude	e	e
laus:Nom.Pl	laudēs	ēs	ēs
laus:Acc.Sg	laudem	em	em
laus:Dat.Pl	laudibus	ibus	ibus
lectus:Nom.Sg	lectus	us	us
lectus:Abl.Pl	lectīs	īs	a
lectus:Dat.Sg	lectō	ō	ō
lectus:Acc.Pl	lectōs	ōs	ōs
lectus:Gen.Sg	lectī	ī	ī
lectus:Gen.Pl	lectōrum	ōrum	ōrum
lectus:Abl.Sg	lectō	ō	ō
lectus:Nom.Pl	lectī	ī	ī
lectus:Acc.Sg	lectum	um	um
lectus:Dat.Pl	lectīs	īs	a
leo:Nom.Sg	leō	NULL	NULL
leo:Abl.Pl	leōnibus	ibus	ibus
leo:Dat.Sg	leōnī	ī	ī
leo:Acc.Pl	leōnēs	ēs	ēs
leo:Gen.Sg	leōnis	is	is
leo:Gen.Pl	leōnum	um	um
leo:Abl.Sg	leōne	e	e
leo:Nom.Pl	leōnēs	ēs	ēs
leo:Acc.Sg	leōnem	em	em
leo:Dat.Pl	leōnibus	ibus	ibus
lex:Nom.Sg	lēx	NULL	NULL
lex:Abl.Pl	lēgibus	ibus	ibus
lex:Dat.Sg	lēgī	ī	ī
lex:Acc.Pl	lēgēs	ēs	ēs
lex:Gen.Sg	lēgis	is	is
lex:Gen.Pl	lēgum	um	um
lex:Abl.Sg	lēge	e	e
lex:Nom.Pl	lēgēs	ēs	ēs
lex:Acc.Sg	lēgem	em	em
lex:Dat.Pl	lēgibus	ibus	ibus
liber:Nom.Sg	liber	NULL	ēs
liber:Abl.Pl	librīs	īs	īs
liber:Dat.Sg	librō	ō	e
liber:Acc.Pl	librōs	ōs	ōs
liber:Gen.Sg	librī	ī	ī
liber:Gen.Pl	librōrum	ōrum	ēs
liber:Abl.Sg	librō	ō	ō
liber:Nom.Pl	librī	ī	ī
liber:Acc.Sg	librum	um	um
liber:Dat.Pl	librīs	īs	īs
libertas:Nom.Sg	lībertās	NULL	NULL
libertas:Abl.Pl	lībertātibus	ibus	ibus
libertas:Dat.Sg	lībertātī	ī	ī
libertas:Acc.Pl	lībertātēs	ēs	ēs
libertas:Gen.Sg	lībertātis	is	is
libertas:Gen.Pl	lībertātum	um	um
libertas:Abl.Sg	lībertāte	e	e
libertas:Nom.Pl	lībertātēs	ēs	ēs
libertas:Acc.Sg	lībertātem	em	em
libertas:Dat.Pl	lībertātibus	ibus	ibus
libido:Nom.Sg	libīdō	NULL	NULL
libido:Abl.Pl	libīdinibus	ibus	ibus
libido:Dat.Sg	libīdinī	ī	ī
libido:Acc.Pl	libīdinēs	ēs	ēs
libido:Gen.Sg	libīdinis	is	is
libido:Gen.Pl	libīdinum	um	um
libido:Abl.Sg	libīdine	e	e
libido:Nom.Pl	libīdinēs	ēs	ēs
libido:Acc.Sg	libīdinem	em	em
libido:Dat.Pl	libīdinibus	ibus	ibus
limen:Nom.Sg	līmen	NULL	NULL
limen:Abl.Pl	līminibus	ibus	ibus
limen:Dat.Sg	līminī	ī	ī
limen:Acc.Pl	līmina	a	a
limen:Gen.Sg	līminis	is	is
limen:Gen.Pl	līminum	um	um
limen:Abl.Sg	līmine	e	e
limen:Nom.Pl	līmina	a	a
limen:Acc.Sg	līmen	NULL	NULL
limen:Dat.Pl	līminibus	ibus	ibus
lingua:Nom.Sg	lingua	a	a
lingua:Abl.Pl	linguīs	īs	īs
lingua:Dat.Sg	linguae	ae	ae
lingua:Acc.Pl	linguās	ās	ās
lingua:Gen.Sg	linguae	ae	ae
lingua:Gen.Pl	linguārum	ārum	ās
lingua:Abl.Sg	linguā	ā	ās
lingua:Nom.Pl	linguae	ae	a
lingua:Acc.Sg	linguam	am	am
lingua:Dat.Pl	linguīs	īs	īs
litus:Nom.Sg	lītus	NULL	NULL
litus:Abl.Pl	lītoribus	ibus	ibus
litus:Dat.Sg	lītorī	ī	ī
litus:Acc.Pl	lītora	a	a
litus:Gen.Sg	lītoris	is	is
litus:Gen.Pl	lītorum	um	um
litus:Abl.Sg	lītore	e	e
litus:Nom.Pl	lītora	a	a
litus:Acc.Sg	lītus	NULL	NULL
litus:Dat.Pl	lītoribus	ibus	ibus
locus:Nom.Sg	locus	us	us
locus:Abl.Pl	locīs	īs	īs
locus:Dat.Sg	locō	ō	ō
locus:Acc.Pl	locōs	ōs	ōs
locus:Gen.Sg	locī	ī	ī
locus:Gen.Pl	locōrum	ōrum	ēs
locus:Abl.Sg	locō	ō	ō
locus:Nom.Pl	locī	ī	ī
locus:Acc.Sg	locum	um	um
locus:Dat.Pl	locīs	īs	īs
luctus:Nom.Sg	luctus	us	us
luctus:Abl.Pl	luctibus	ibus	ibus
luctus:Dat.Sg	luctuī	uī	um
luctus:Acc.Pl	luctūs	ūs	us
luctus:Gen.Sg	luctūs	ūs	ūs
luctus:Gen.Pl	luctuum	uum	ēs
luctus:Abl.Sg	luctū	ū	ū
luctus:Nom.Pl	luctūs	ūs	us
luctus:Acc.Sg	luctum	um	um
luctus:Dat.Pl	luctibus	ibus	ibus
lucus:Nom.Sg	lūcus	us	us
lucus:Abl.Pl	lūcīs	īs	īs
lucus:Dat.Sg	lūcō	ō	ō
lucus:Acc.Pl	lūcōs	ōs	ōs
lucus:Gen.Sg	lūcī	ī	ī
lucus:Gen.Pl	lūcōrum	ōrum	ēs
lucus:Abl.Sg	lūcō	ō	ō
lucus:Nom.Pl	lūcī	ī	ī
lucus:Acc.Sg	lūcum	um	um
lucus:Dat.Pl	lūcīs	īs	īs
ludus:Nom.Sg	lūdus	us	us
ludus:Abl.Pl	lūdīs	īs	īs
ludus:Dat.Sg	lūdō	ō	ō
ludus:Acc.Pl	lūdōs	ōs	ōs
ludus:Gen.Sg	lūdī	ī	ī
ludus:Gen.Pl	lūdōrum	ōrum	ēs
ludus:Abl.Sg	lūdō	ō	ō
ludus:Nom.Pl	lūdī	ī	ī
ludus:Acc.Sg	lūdum	um	um
ludus:Dat.Pl	lūdīs	īs	īs
lumen:Nom.Sg	lūmen	NULL	NULL
lumen:Abl.Pl	lūminibus	ibus	ibus
lumen:Dat.Sg	lūminī	ī	ī
lumen:Acc.Pl	lūmina	a	a
lumen:Gen.Sg	lūminis	is	is
lumen:Gen.Pl	lūminum	um	um
lumen:Abl.Sg	lūmine	e	e
lumen:Nom.Pl	lūmina	a	a
lumen:Acc.Sg	lūmen	NULL	NULL
lumen:Dat.Pl	lūminibus	ibus	ibus
luna:Nom.Sg	lūna	a	a
luna:Abl.Pl	lūnīs	īs	īs
luna:Dat.Sg	lūnae	ae	ae
luna:Acc.Pl	lūnās	ās	ās
luna:Gen.Sg	lūnae	ae	ae
luna:Gen.Pl	lūnārum	ārum	ā
luna:Abl.Sg	lūnā	ā	ā
luna:Nom.Pl	lūnae	ae	a
luna:Acc.Sg	lūnam	am	am
luna:Dat.Pl	lūnīs	īs	īs
lux:Nom.Sg	lūx	NULL	NULL
lux:Abl.Pl	lūcibus	ibus	ibus
lux:Dat.Sg	lūcī	ī	ī
lux:Acc.Pl	lūcēs	ēs	ēs
lux:Gen.Sg	lūcis	is	is
lux:Gen.Pl	lūcum	um	um
lux:Abl.Sg	lūce	e	e
lux:Nom.Pl	lūcēs	ēs	ēs
lux:Acc.Sg	lūcem	em	em
lux:Dat.Pl	lūcibus	ibus	ibus
luxuria:Nom.Sg	luxuria	a	a
luxuria:Abl.Pl	luxuriīs	īs	īs
luxuria:Dat.Sg	luxuriae	ae	ae
luxuria:Acc.Pl	luxuriās	ās	ās
luxuria:Gen.Sg	luxuriae	ae	a
luxuria:Gen.Pl	luxuriārum	ārum	ā
luxuria:Abl.Sg	luxuriā	ā	ā
luxuria:Nom.Pl	luxuriae	ae	a
luxuria:Acc.Sg	luxuriam	am	am
luxuria:Dat.Pl	luxuriīs	īs	īs
magister:Nom.Sg	magister	NULL	ēs
magister:Abl.Pl	magistrīs	īs	ium
magister:Dat.Sg	magistrō	ō	e
magister:Acc.Pl	magistrōs	ōs	ium
magister:Gen.Sg	magistrī	ī	ū
magister:Gen.Pl	magistrōrum	ōrum	ēs
magister:Abl.Sg	magistrō	ō	ō
magister:Nom.Pl	magistrī	ī	ēs
magister:Acc.Sg	magistrum	um	um
magister:Dat.Pl	magistrīs	īs	a
malum:Nom.Sg	malum	um	um
malum:Abl.Pl	malīs	īs	īs
malum:Dat.Sg	malō	ō	ō
malum:Acc.Pl	mala	a	a
malum:Gen.Sg	malī	ī	ī
malum:Gen.Pl	malōrum	ōrum	ēs
malum:Abl.Sg	malō	ō	ō
malum:Nom.Pl	mala	a	a
malum:Acc.Sg	malum	um	um
malum:Dat.Pl	malīs	īs	īs
manus:Nom.Sg	manus	us	us
manus:Abl.Pl	manibus	ibus	ibus
manus:Dat.Sg	manuī	uī	um
manus:Acc.Pl	manūs	ūs	us
manus:Gen.Sg	manūs	ūs	ūs
manus:Gen.Pl	manuum	uum	ēs
manus:Abl.Sg	manū	ū	ū
manus:Nom.Pl	manūs	ūs	us
manus:Acc.Sg	manum	um	um
manus:Dat.Pl	manibus	ibus	ibus
mare:Nom.Sg	mare	e	e
mare:Abl.Pl	maribus	ibus	ibus
mare:Dat.Sg	marī	ī	ī
mare:Acc.Pl	maria	ia	ium
mare:Gen.Sg	maris	is	is
mare:Gen.Pl	marium	ium	ium
mare:Abl.Sg	marī	ī	ū
mare:Nom.Pl	maria	ia	a
mare:Acc.Sg	mare	e	e
mare:Dat.Pl	maribus	ibus	ibus
maritus:Nom.Sg	marītus	us	us
maritus:Abl.Pl	marītīs	īs	īs
maritus:Dat.Sg	marītō	ō	e
maritus:Acc.Pl	marītōs	ōs	ōs
maritus:Gen.Sg	marītī	ī	ī
maritus:Gen.Pl	marītōrum	ōrum	ēs
maritus:Abl.Sg	marītō	ō	ō
maritus:Nom.Pl	marītī	ī	ī
maritus:Acc.Sg	marītum	um	um
maritus:Dat.Pl	marītīs	īs	īs
mater:Nom.Sg	māter	NULL	em
mater:Abl.Pl	mātribus	ibus	ibus
mater:Dat.Sg	mātrī	ī	ī
mater:Acc.Pl	mātrēs	ēs	ēs
mater:Gen.Sg	mātris	is	is
mater:Gen.Pl	mātrum	um	um
mater:Abl.Sg	mātre	e	e
mater:Nom.Pl	mātrēs	ēs	ēs
mater:Acc.Sg	mātrem	em	em
mater:Dat.Pl	mātribus	ibus	ibus
medium:Nom.Sg	medium	um	um
medium:Abl.Pl	mediīs	īs	īs
medium:Dat.Sg	mediō	ō	ō
medium:Acc.Pl	media	a	a
medium:Gen.Sg	mediī	ī	ī
medium:Gen.Pl	mediōrum	ōrum	ēs
medium:Abl.Sg	mediō	ō	ō
medium:Nom.Pl	media	a	a
medium:Acc.Sg	medium	um	um
medium:Dat.Pl	mediīs	īs	īs
membrum:Nom.Sg	membrum	um	um
membrum:Abl.Pl	membrīs	īs	īs
membrum:Dat.Sg	membrō	ō	ō
membrum:Acc.Pl	membra	a	a
membrum:Gen.Sg	membrī	ī	ī
membrum:Gen.Pl	membrōrum	ōrum	ōrum
membrum:Abl.Sg	membrō	ō	ō
membrum:Nom.Pl	membra	a	a
membrum:Acc.Sg	membrum	um	um
membrum:Dat.Pl	membrīs	īs	īs
mens:Nom.Sg	mēns	NULL	NULL
mens:Abl.Pl	mentibus	ibus	ibus
mens:Dat.Sg	mentī	ī	ī
mens:Acc.Pl	mentēs	ēs	ēs
mens:Gen.Sg	mentis	is	is
mens:Gen.Pl	mentium	ium	ium
mens:Abl.Sg	mente	e	e
mens:Nom.Pl	mentēs	ēs	ēs
mens:Acc.Sg	mentem	em	em
mens:Dat.Pl	mentibus	ibus	ibus
mensa:Nom.Sg	mēnsa	a	a
mensa:Abl.Pl	mēnsīs	īs	īs
mensa:Dat.Sg	mēnsae	ae	ae
mensa:Acc.Pl	mēnsās	ās	ās
mensa:Gen.Sg	mēnsae	ae	ae
mensa:Gen.Pl	mēnsārum	ārum	ā
mensa:Abl.Sg	mēnsā	ā	ā
mensa:Nom.Pl	mēnsae	ae	a
mensa:Acc.Sg	mēnsam	am	am
mensa:Dat.Pl	mēnsīs	īs	īs
mensis:Nom.Sg	mēnsis	is	īs
mensis:Abl.Pl	mēnsibus	ibus	ibus
mensis:Dat.Sg	mēnsī	ī	ī
mensis:Acc.Pl	mēnsēs	ēs	ēs
mensis:Gen.Sg	mēnsis	is	is
mensis:Gen.Pl	mēnsium	ium	ium
mensis:Abl.Sg	mēnse	e	e
mensis:Nom.Pl	mēnsēs	ēs	ēs
mensis:Acc.Sg	mēnsem	em	em
mensis:Dat.Pl	mēnsibus	ibus	ibus
merces:Nom.Sg	mercēs	NULL	NULL
merces:Abl.Pl	mercēdibus	ibus	ibus
merces:Dat.Sg	mercēdī	ī	ī
merces:Acc.Pl	mercēdēs	ēs	ēs
merces:Gen.Sg	mercēdis	is	is
merces:Gen.Pl	mercēdum	um	um
merces:Abl.Sg	mercēde	e	e
merces:Nom.Pl	mercēdēs	ēs	ēs
merces:Acc.Sg	mercēdem	em	em
merces:Dat.Pl	mercēdibus	ibus	ibus
meritum:Nom.Sg	meritum	um	um
meritum:Abl.Pl	meritīs	īs	īs
meritum:Dat.Sg	meritō	ō	ō
meritum:Acc.Pl	merita	a	a
meritum:Gen.Sg	meritī	ī	ī
meritum:Gen.Pl	meritōrum	ōrum	ēs
meritum:Abl.Sg	meritō	ō	ō
meritum:Nom.Pl	merita	a	a
meritum:Acc.Sg	meritum	um	um
meritum:Dat.Pl	meritīs	īs	īs
merum:Nom.Sg	merum	um	um
merum:Abl.Pl	merīs	īs	īs
merum:Dat.Sg	merō	ō	ō
merum:Acc.Pl	mera	a	a
merum:Gen.Sg	merī	ī	ī
merum:Gen.Pl	merōrum	ōrum	ēs
merum:Abl.Sg	merō	ō	ō
merum:Nom.Pl	mera	a	a
merum:Acc.Sg	merum	um	um
merum:Dat.Pl	merīs	īs	īs
metus:Nom.Sg	metus	us	us
metus:Abl.Pl	metibus	ibus	ibus
metus:Dat.Sg	metuī	uī	um
metus:Acc.Pl	metūs	ūs	us
metus:Gen.Sg	metūs	ūs	ūs
metus:Gen.Pl	metuum	uum	ēs
metus:Abl.Sg	metū	ū	ū
metus:Nom.Pl	metūs	ūs	us
metus:Acc.Sg	metum	um	um
metus:Dat.Pl	metibus	ibus	ibus
miles:Nom.Sg	mīles	NULL	NULL
miles:Abl.Pl	mīlitibus	ibus	ibus
miles:Dat.Sg	mīlitī	ī	ī
miles:Acc.Pl	mīlitēs	ēs	ēs
miles:Gen.Sg	mīlitis	is	is
miles:Gen.Pl	mīlitum	um	um
miles:Abl.Sg	mīlite	e	e
miles:Nom.Pl	mīlitēs	ēs	ēs
miles:Acc.Sg	mīlitem	em	em
miles:Dat.Pl	mīlitibus	ibus	ibus
militia:Nom.Sg	mīlitia	a	a
militia:Abl.Pl	mīlitiīs	īs	īs
militia:Dat.Sg	mīlitiae	ae	a
militia:Acc.Pl	mīlitiās	ās	ās
militia:Gen.Sg	mīlitiae	ae	a
militia:Gen.Pl	mīlitiārum	ārum	ās
militia:Abl.Sg	mīlitiā	ā	ās
militia:Nom.Pl	mīlitiae	ae	a
militia:Acc.Sg	mīlitiam	am	ās
militia:Dat.Pl	mīlitiīs	īs	īs
minae:Nom.Sg	N/AN/A	N/A	N/A
minae:Abl.Pl	minīs	īs	īs
minae:Dat.Sg	N/AN/A	N/A	a
minae:Acc.Pl	minās	ās	ās
minae:Gen.Sg	N/AN/A	N/A	N/A
minae:Gen.Pl	minārum	ārum	ā
minae:Abl.Sg	N/AN/A	N/A	N/A
minae:Nom.Pl	minae	ae	a
minae:Acc.Sg	N/AN/A	N/A	N/A
minae:Dat.Pl	minīs	īs	īs
minister:Nom.Sg	minister	NULL	ēs
minister:Abl.Pl	ministrīs	īs	a
minister:Dat.Sg	ministrō	ō	e
minister:Acc.Pl	ministrōs	ōs	ium
minister:Gen.Sg	ministrī	ī	ū
minister:Gen.Pl	ministrōrum	ōrum	ēs
minister:Abl.Sg	ministrō	ō	ō
minister:Nom.Pl	ministrī	ī	ēs
minister:Acc.Sg	ministrum	um	um
minister:Dat.Pl	ministrīs	īs	a
modus:Nom.Sg	modus	us	us
modus:Abl.Pl	modīs	īs	īs
modus:Dat.Sg	modō	ō	ō
modus:Acc.Pl	modōs	ōs	ōs
modus:Gen.Sg	modī	ī	ī
modus:Gen.Pl	modōrum	ōrum	ēs
modus:Abl.Sg	modō	ō	ō
modus:Nom.Pl	modī	ī	ī
modus:Acc.Sg	modum	um	um
modus:Dat.Pl	modīs	īs	īs
moenia:Nom.Sg	N/AN/A	N/A	N/A
moenia:Abl.Pl	moenibus	ibus	ibus
moenia:Dat.Sg	N/AN/A	N/A	ī
moenia:Acc.Pl	moenia	ia	ium
moenia:Gen.Sg	N/AN/A	N/A	N/A
moenia:Gen.Pl	moenium	ium	us
moenia:Abl.Sg	N/AN/A	N/A	N/A
moenia:Nom.Pl	moenia	ia	a
moenia:Acc.Sg	N/AN/A	N/A	N/A
moenia:Dat.Pl	moenibus	ibus	ibus
moles:Nom.Sg	mōlēs	ēs	ēs
moles:Abl.Pl	mōlibus	ibus	ibus
moles:Dat.Sg	mōlī	ī	ī
moles:Acc.Pl	mōlēs	ēs	ēs
moles:Gen.Sg	mōlis	is	is
moles:Gen.Pl	mōlium	ium	ium
moles:Abl.Sg	mōle	e	e
moles:Nom.Pl	mōlēs	ēs	ēs
moles:Acc.Sg	mōlem	em	em
moles:Dat.Pl	mōlibus	ibus	ibus
mons:Nom.Sg	mōns	NULL	NULL
mons:Abl.Pl	montibus	ibus	ibus
mons:Dat.Sg	montī	ī	ī
mons:Acc.Pl	montēs	ēs	ēs
mons:Gen.Sg	montis	is	is
mons:Gen.Pl	montium	ium	ium
mons:Abl.Sg	monte	e	e
mons:Nom.Pl	montēs	ēs	ēs
mons:Acc.Sg	montem	em	em
mons:Dat.Pl	montibus	ibus	ibus
monstrum:Nom.Sg	mōnstrum	um	um
monstrum:Abl.Pl	mōnstrīs	īs	ium
monstrum:Dat.Sg	mōnstrō	ō	ō
monstrum:Acc.Pl	mōnstra	a	am
monstrum:Gen.Sg	mōnstrī	ī	ū
monstrum:Gen.Pl	mōnstrōrum	ōrum	ōrum
monstrum:Abl.Sg	mōnstrō	ō	ō
monstrum:Nom.Pl	mōnstra	a	ēs
monstrum:Acc.Sg	mōnstrum	um	um
monstrum:Dat.Pl	mōnstrīs	īs	a
monumentum:Nom.Sg	monumentum	um	ēs
monumentum:Abl.Pl	monumentīs	īs	īs
monumentum:Dat.Sg	monumentō	ō	e
monumentum:Acc.Pl	monumenta	a	a
monumentum:Gen.Sg	monumentī	ī	ī
monumentum:Gen.Pl	monumentōrum	ōrum	ēs
monumentum:Abl.Sg	monumentō	ō	em
monumentum:Nom.Pl	monumenta	a	a
monumentum:Acc.Sg	monumentum	um	ēs
monumentum:Dat.Pl	monumentīs	īs	īs
mora:Nom.Sg	mora	a	a
mora:Abl.Pl	morīs	īs	īs
mora:Dat.Sg	morae	ae	ae
mora:Acc.Pl	morās	ās	ās
mora:Gen.Sg	morae	ae	ae
mora:Gen.Pl	morārum	ārum	ās
mora:Abl.Sg	morā	ā	ās
mora:Nom.Pl	morae	ae	a
mora:Acc.Sg	moram	am	am
mora:Dat.Pl	morīs	īs	īs
morbus:Nom.Sg	morbus	us	us
morbus:Abl.Pl	morbīs	īs	īs
morbus:Dat.Sg	morbō	ō	ō
morbus:Acc.Pl	morbōs	ōs	ōs
morbus:Gen.Sg	morbī	ī	ī
morbus:Gen.Pl	morbōrum	ōrum	ēs
morbus:Abl.Sg	morbō	ō	ō
morbus:Nom.Pl	morbī	ī	ī
morbus:Acc.Sg	morbum	um	um
morbus:Dat.Pl	morbīs	īs	īs
mors:Nom.Sg	mors	NULL	NULL
mors:Abl.Pl	mortibus	ibus	ibus
mors:Dat.Sg	mortī	ī	ī
mors:Acc.Pl	mortēs	ēs	ēs
mors:Gen.Sg	mortis	is	is
mors:Gen.Pl	mortium	ium	ium
mors:Abl.Sg	morte	e	e
mors:Nom.Pl	mortēs	ēs	ēs
mors:Acc.Sg	mortem	em	em
mors:Dat.Pl	mortibus	ibus	ibus
mos:Nom.Sg	mōs	NULL	NULL
mos:Abl.Pl	mōribus	ibus	ibus
mos:Dat.Sg	mōrī	ī	ī
mos:Acc.Pl	mōrēs	ēs	ēs
mos:Gen.Sg	mōris	is	is
mos:Gen.Pl	mōrum	um	um
mos:Abl.Sg	mōre	e	e
mos:Nom.Pl	mōrēs	ēs	ēs
mos:Acc.Sg	mōrem	em	em
mos:Dat.Pl	mōribus	ibus	ibus
motus:Nom.Sg	mōtus	us	us
motus:Abl.Pl	mōtibus	ibus	ibus
motus:Dat.Sg	mōtuī	uī	um
motus:Acc.Pl	mōtūs	ūs	us
motus:Gen.Sg	mōtūs	ūs	ūs
motus:Gen.Pl	mōtuum	uum	ēs
motus:Abl.Sg	mōtū	ū	ū
motus:Nom.Pl	mōtūs	ūs	us
motus:Acc.Sg	mōtum	um	um
motus:Dat.Pl	mōtibus	ibus	ibus
mulier:Nom.Sg	mulier	NULL	NULL
mulier:Abl.Pl	mulieribus	ibus	ibus
mulier:Dat.Sg	mulierī	ī	ī
mulier:Acc.Pl	mulierēs	ēs	ēs
mulier:Gen.Sg	mulieris	is	īs
mulier:Gen.Pl	mulierum	um	um
mulier:Abl.Sg	muliere	e	e
mulier:Nom.Pl	mulierēs	ēs	ēs
mulier:Acc.Sg	mulierem	em	ēs
mulier:Dat.Pl	mulieribus	ibus	ibus
mundus:Nom.Sg	mundus	us	us
mundus:Abl.Pl	mundīs	īs	īs
mundus:Dat.Sg	mundō	ō	ō
mundus:Acc.Pl	mundōs	ōs	ōs
mundus:Gen.Sg	mundī	ī	ī
mundus:Gen.Pl	mundōrum	ōrum	ēs
mundus:Abl.Sg	mundō	ō	ō
mundus:Nom.Pl	mundī	ī	ī
mundus:Acc.Sg	mundum	um	um
mundus:Dat.Pl	mundīs	īs	īs
munus:Nom.Sg	mūnus	NULL	NULL
munus:Abl.Pl	mūneribus	ibus	ibus
munus:Dat.Sg	mūnerī	ī	ī
munus:Acc.Pl	mūnera	a	a
munus:Gen.Sg	mūneris	is	is
munus:Gen.Pl	mūnerum	um	um
munus:Abl.Sg	mūnere	e	e
munus:Nom.Pl	mūnera	a	a
munus:Acc.Sg	mūnus	NULL	NULL
munus:Dat.Pl	mūneribus	ibus	ibus
murus:Nom.Sg	mūrus	us	us
murus:Abl.Pl	mūrīs	īs	īs
murus:Dat.Sg	mūrō	ō	ō
murus:Acc.Pl	mūrōs	ōs	ōs
murus:Gen.Sg	mūrī	ī	ī
murus:Gen.Pl	mūrōrum	ōrum	ōrum
murus:Abl.Sg	mūrō	ō	ō
murus:Nom.Pl	mūrī	ī	ī
murus:Acc.Sg	mūrum	um	um
murus:Dat.Pl	mūrīs	īs	īs
natura:Nom.Sg	nātūra	a	a
natura:Abl.Pl	nātūrīs	īs	īs
natura:Dat.Sg	nātūrae	ae	a
natura:Acc.Pl	nātūrās	ās	ās
natura:Gen.Sg	nātūrae	ae	a
natura:Gen.Pl	nātūrārum	ārum	ās
natura:Abl.Sg	nātūrā	ā	ā
natura:Nom.Pl	nātūrae	ae	a
natura:Acc.Sg	nātūram	am	am
natura:Dat.Pl	nātūrīs	īs	īs
nauta:Nom.Sg	nauta	a	a
nauta:Abl.Pl	nautīs	īs	īs
nauta:Dat.Sg	nautae	ae	ae
nauta:Acc.Pl	nautās	ās	ās
nauta:Gen.Sg	nautae	ae	ae
nauta:Gen.Pl	nautārum	ārum	ā
nauta:Abl.Sg	nautā	ā	ā
nauta:Nom.Pl	nautae	ae	a
nauta:Acc.Sg	nautam	am	ās
nauta:Dat.Pl	nautīs	īs	īs
navis:Nom.Sg	nāvis	is	īs
navis:Abl.Pl	nāvibus	ibus	ibus
navis:Dat.Sg	nāvī	ī	ī
navis:Acc.Pl	nāvēs	ēs	ēs
navis:Gen.Sg	nāvis	is	is
navis:Gen.Pl	nāvium	ium	a
navis:Abl.Sg	nāve	e	e
navis:Nom.Pl	nāvēs	ēs	ēs
navis:Acc.Sg	nāvem	em	em
navis:Dat.Pl	nāvibus	ibus	ibus
nemus:Nom.Sg	nemus	NULL	NULL
nemus:Abl.Pl	nemoribus	ibus	ibus
nemus:Dat.Sg	nemorī	ī	ī
nemus:Acc.Pl	nemora	a	a
nemus:Gen.Sg	nemoris	is	is
nemus:Gen.Pl	nemorum	um	um
nemus:Abl.Sg	nemore	e	e
nemus:Nom.Pl	nemora	a	a
nemus:Acc.Sg	nemus	NULL	NULL
nemus:Dat.Pl	nemoribus	ibus	ibus
nepos:Nom.Sg	nepōs	NULL	NULL
nepos:Abl.Pl	nepōtibus	ibus	ibus
nepos:Dat.Sg	nepōtī	ī	ī
nepos:Acc.Pl	nepōtēs	ēs	ēs
nepos:Gen.Sg	nepōtis	is	is
nepos:Gen.Pl	nepōtum	um	um
nepos:Abl.Sg	nepōte	e	e
nepos:Nom.Pl	nepōtēs	ēs	ēs
nepos:Acc.Sg	nepōtem	em	em
nepos:Dat.Pl	nepōtibus	ibus	ibus
nequitia:Nom.Sg	nēquitia	a	a
nequitia:Abl.Pl	nēquitiīs	īs	īs
nequitia:Dat.Sg	nēquitiae	ae	es
nequitia:Acc.Pl	nēquitiās	ās	ās
nequitia:Gen.Sg	nēquitiae	ae	a
nequitia:Gen.Pl	nēquitiārum	ārum	ās
nequitia:Abl.Sg	nēquitiā	ā	ās
nequitia:Nom.Pl	nēquitiae	ae	N/A
nequitia:Acc.Sg	nēquitiam	am	am
nequitia:Dat.Pl	nēquitiīs	īs	īs
nex:Nom.Sg	nex	NULL	NULL
nex:Abl.Pl	necibus	ibus	ibus
nex:Dat.Sg	necī	ī	ī
nex:Acc.Pl	necēs	ēs	ēs
nex:Gen.Sg	necis	is	is
nex:Gen.Pl	necum	um	um
nex:Abl.Sg	nece	e	e
nex:Nom.Pl	necēs	ēs	ēs
nex:Acc.Sg	necem	em	em
nex:Dat.Pl	necibus	ibus	ibus
nix:Nom.Sg	nix	NULL	NULL
nix:Abl.Pl	nivibus	ibus	ibus
nix:Dat.Sg	nivī	ī	ī
nix:Acc.Pl	nivēs	ēs	ēs
nix:Gen.Sg	nivis	is	is
nix:Gen.Pl	nivium	ium	a
nix:Abl.Sg	nive	e	e
nix:Nom.Pl	nivēs	ēs	ēs
nix:Acc.Sg	nivem	em	em
nix:Dat.Pl	nivibus	ibus	ibus
nomen:Nom.Sg	nōmen	NULL	NULL
nomen:Abl.Pl	nōminibus	ibus	ibus
nomen:Dat.Sg	nōminī	ī	ī
nomen:Acc.Pl	nōmina	a	a
nomen:Gen.Sg	nōminis	is	is
nomen:Gen.Pl	nōminum	um	um
nomen:Abl.Sg	nōmine	e	e
nomen:Nom.Pl	nōmina	a	a
nomen:Acc.Sg	nōmen	NULL	NULL
nomen:Dat.Pl	nōminibus	ibus	ibus
nota:Nom.Sg	nota	a	a
nota:Abl.Pl	notīs	īs	īs
nota:Dat.Sg	notae	ae	ae
nota:Acc.Pl	notās	ās	ās
nota:Gen.Sg	notae	ae	ae
nota:Gen.Pl	notārum	ārum	ā
nota:Abl.Sg	notā	ā	ā
nota:Nom.Pl	notae	ae	a
nota:Acc.Sg	notam	am	am
nota:Dat.Pl	notīs	īs	īs
nox:Nom.Sg	nox	NULL	NULL
nox:Abl.Pl	noctibus	ibus	ibus
nox:Dat.Sg	noctī	ī	ī
nox:Acc.Pl	noctēs	ēs	ēs
nox:Gen.Sg	noctis	is	is
nox:Gen.Pl	noctium	ium	us
nox:Abl.Sg	nocte	e	e
nox:Nom.Pl	noctēs	ēs	ēs
nox:Acc.Sg	noctem	em	em
nox:Dat.Pl	noctibus	ibus	ibus
nubes:Nom.Sg	nūbēs	ēs	ēs
nubes:Abl.Pl	nūbibus	ibus	ibus
nubes:Dat.Sg	nūbī	ī	ī
nubes:Acc.Pl	nūbēs	ēs	ēs
nubes:Gen.Sg	nūbis	is	is
nubes:Gen.Pl	nūbium	ium	ēbus
nubes:Abl.Sg	nūbe	e	e
nubes:Nom.Pl	nūbēs	ēs	ēs
nubes:Acc.Sg	nūbem	em	em
nubes:Dat.Pl	nūbibus	ibus	ibus
numen:Nom.Sg	nūmen	NULL	NULL
numen:Abl.Pl	nūminibus	ibus	ibus
numen:Dat.Sg	nūminī	ī	ī
numen:Acc.Pl	nūmina	a	a
numen:Gen.Sg	nūminis	is	is
numen:Gen.Pl	nūminum	um	um
numen:Abl.Sg	nūmine	e	e
numen:Nom.Pl	nūmina	a	a
numen:Acc.Sg	nūmen	NULL	NULL
numen:Dat.Pl	nūminibus	ibus	ibus
numerus:Nom.Sg	numerus	us	us
numerus:Abl.Pl	numerīs	īs	īs
numerus:Dat.Sg	numerō	ō	ō
numerus:Acc.Pl	numerōs	ōs	ūs
numerus:Gen.Sg	numerī	ī	ī
numerus:Gen.Pl	numerōrum	ōrum	ēs
numerus:Abl.Sg	numerō	ō	ō
numerus:Nom.Pl	numerī	ī	ī
numerus:Acc.Sg	numerum	um	um
numerus:Dat.Pl	numerīs	īs	īs
nuntius:Nom.Sg	nūntius	us	us
nuntius:Abl.Pl	nūntiīs	īs	īs
nuntius:Dat.Sg	nūntiō	ō	ō
nuntius:Acc.Pl	nūntiōs	ōs	ibus
nuntius:Gen.Sg	nūntiī	ī	ī
nuntius:Gen.Pl	nūntiōrum	ōrum	ēs
nuntius:Abl.Sg	nūntiō	ō	ō
nuntius:Nom.Pl	nūntiī	ī	ī
nuntius:Acc.Sg	nūntium	um	um
nuntius:Dat.Pl	nūntiīs	īs	īs
oculus:Nom.Sg	oculus	us	us
oculus:Abl.Pl	oculīs	īs	īs
oculus:Dat.Sg	oculō	ō	ō
oculus:Acc.Pl	oculōs	ōs	ūs
oculus:Gen.Sg	oculī	ī	ī
oculus:Gen.Pl	oculōrum	ōrum	ēs
oculus:Abl.Sg	oculō	ō	ō
oculus:Nom.Pl	oculī	ī	ī
oculus:Acc.Sg	oculum	um	um
oculus:Dat.Pl	oculīs	īs	īs
odium:Nom.Sg	odium	um	um
odium:Abl.Pl	odiīs	īs	īs
odium:Dat.Sg	odiō	ō	ō
odium:Acc.Pl	odia	a	a
odium:Gen.Sg	odiī	ī	ī
odium:Gen.Pl	odiōrum	ōrum	ēs
odium:Abl.Sg	odiō	ō	em
odium:Nom.Pl	odia	a	a
odium:Acc.Sg	odium	um	um
odium:Dat.Pl	odiīs	īs	īs
odor:Nom.Sg	odor	NULL	NULL
odor:Abl.Pl	odōribus	ibus	ibus
odor:Dat.Sg	odōrī	ī	ī
odor:Acc.Pl	odōrēs	ēs	ēs
odor:Gen.Sg	odōris	is	is
odor:Gen.Pl	odōrum	um	um
odor:Abl.Sg	odōre	e	e
odor:Nom.Pl	odōrēs	ēs	ēs
odor:Acc.Sg	odōrem	em	em
odor:Dat.Pl	odōribus	ibus	ibus
officium:Nom.Sg	officium	um	um
officium:Abl.Pl	officiīs	īs	īs
officium:Dat.Sg	officiō	ō	e
officium:Acc.Pl	officia	a	a
officium:Gen.Sg	officiī	ī	ī
officium:Gen.Pl	officiōrum	ōrum	ium
officium:Abl.Sg	officiō	ō	e
officium:Nom.Pl	officia	a	a
officium:Acc.Sg	officium	um	um
officium:Dat.Pl	officiīs	īs	īs
omen:Nom.Sg	ōmen	NULL	NULL
omen:Abl.Pl	ōminibus	ibus	ibus
omen:Dat.Sg	ōminī	ī	ī
omen:Acc.Pl	ōmina	a	a
omen:Gen.Sg	ōminis	is	is
omen:Gen.Pl	ōminum	um	um
omen:Abl.Sg	ōmine	e	e
omen:Nom.Pl	ōmina	a	a
omen:Acc.Sg	ōmen	NULL	NULL
omen:Dat.Pl	ōminibus	ibus	ibus
onus:Nom.Sg	onus	NULL	NULL
onus:Abl.Pl	oneribus	ibus	ibus
onus:Dat.Sg	onerī	ī	ī
onus:Acc.Pl	onera	a	a
onus:Gen.Sg	oneris	is	is
onus:Gen.Pl	onerum	um	um
onus:Abl.Sg	onere	e	e
onus:Nom.Pl	onera	a	a
onus:Acc.Sg	onus	NULL	NULL
onus:Dat.Pl	oneribus	ibus	ibus
oppidum:Nom.Sg	oppidum	um	um
oppidum:Abl.Pl	oppidīs	īs	īs
oppidum:Dat.Sg	oppidō	ō	ō
oppidum:Acc.Pl	oppida	a	a
oppidum:Gen.Sg	oppidī	ī	ī
oppidum:Gen.Pl	oppidōrum	ōrum	ēs
oppidum:Abl.Sg	oppidō	ō	em
oppidum:Nom.Pl	oppida	a	a
oppidum:Acc.Sg	oppidum	um	um
oppidum:Dat.Pl	oppidīs	īs	īs
ops:Nom.Sg	ops	NULL	NULL
ops:Abl.Pl	opibus	ibus	ibus
ops:Dat.Sg	opī	ī	ī
ops:Acc.Pl	opēs	ēs	ēs
ops:Gen.Sg	opis	is	is
ops:Gen.Pl	opum	um	ēs
ops:Abl.Sg	ope	e	e
ops:Nom.Pl	opēs	ēs	ēs
ops:Acc.Sg	opem	em	em
ops:Dat.Pl	opibus	ibus	ibus
opus:Nom.Sg	opus	NULL	NULL
opus:Abl.Pl	operibus	ibus	ibus
opus:Dat.Sg	operī	ī	ī
opus:Acc.Pl	opera	a	a
opus:Gen.Sg	operis	is	is
opus:Gen.Pl	operum	um	um
opus:Abl.Sg	opere	e	e
opus:Nom.Pl	opera	a	a
opus:Acc.Sg	opus	NULL	NULL
opus:Dat.Pl	operibus	ibus	ibus
ora:Nom.Sg	ōra	a	a
ora:Abl.Pl	ōrīs	īs	īs
ora:Dat.Sg	ōrae	ae	ae
ora:Acc.Pl	ōrās	ās	ās
ora:Gen.Sg	ōrae	ae	ae
ora:Gen.Pl	ōrārum	ārum	ā
ora:Abl.Sg	ōrā	ā	ā
ora:Nom.Pl	ōrae	ae	a
ora:Acc.Sg	ōram	am	am
ora:Dat.Pl	ōrīs	īs	īs
orbis:Nom.Sg	orbis	is	īs
orbis:Abl.Pl	orbibus	ibus	ibus
orbis:Dat.Sg	orbī	ī	ī
orbis:Acc.Pl	orbēs	ēs	ēs
orbis:Gen.Sg	orbis	is	is
orbis:Gen.Pl	orbium	ium	ium
orbis:Abl.Sg	orbe	e	e
orbis:Nom.Pl	orbēs	ēs	ēs
orbis:Acc.Sg	orbem	em	em
orbis:Dat.Pl	orbibus	ibus	ibus
ordo:Nom.Sg	ōrdō	NULL	NULL
ordo:Abl.Pl	ōrdinibus	ibus	ibus
ordo:Dat.Sg	ōrdinī	ī	ī
ordo:Acc.Pl	ōrdinēs	ēs	ēs
ordo:Gen.Sg	ōrdinis	is	is
ordo:Gen.Pl	ōrdinum	um	um
ordo:Abl.Sg	ōrdine	e	e
ordo:Nom.Pl	ōrdinēs	ēs	ēs
ordo:Acc.Sg	ōrdinem	em	em
ordo:Dat.Pl	ōrdinibus	ibus	ibus
origo:Nom.Sg	orīgō	NULL	NULL
origo:Abl.Pl	orīginibus	ibus	ibus
origo:Dat.Sg	orīginī	ī	ī
origo:Acc.Pl	orīginēs	ēs	ēs
origo:Gen.Sg	orīginis	is	is
origo:Gen.Pl	orīginum	um	um
origo:Abl.Sg	orīgine	e	e
origo:Nom.Pl	orīginēs	ēs	ēs
origo:Acc.Sg	orīginem	em	ēs
origo:Dat.Pl	orīginibus	ibus	ibus
ortus:Nom.Sg	ortus	us	us
ortus:Abl.Pl	ortibus	ibus	ibus
ortus:Dat.Sg	ortuī	uī	um
ortus:Acc.Pl	ortūs	ūs	us
ortus:Gen.Sg	ortūs	ūs	ūs
ortus:Gen.Pl	ortuum	uum	ēs
ortus:Abl.Sg	ortū	ū	ū
ortus:Nom.Pl	ortūs	ūs	us
ortus:Acc.Sg	ortum	um	um
ortus:Dat.Pl	ortibus	ibus	ibus
os:Nom.Sg	os	NULL	NULL
os:Abl.Pl	ossibus	ibus	ibus
os:Dat.Sg	ossī	ī	ī
os:Acc.Pl	ossa	a	a
os:Gen.Sg	ossis	is	is
os:Gen.Pl	ossium	ium	ium
os:Abl.Sg	osse	e	e
os:Nom.Pl	ossa	a	a
os:Acc.Sg	os	NULL	NULL
os:Dat.Pl	ossibus	ibus	ibus
os:Nom.Sg	ōs	NULL	NULL
os:Abl.Pl	ōribus	ibus	ibus
os:Dat.Sg	ōrī	ī	ī
os:Acc.Pl	ōra	a	a
os:Gen.Sg	ōris	is	is
os:Gen.Pl	ōrum	um	um
os:Abl.Sg	ōre	e	e
os:Nom.Pl	ōra	a	a
os:Acc.Sg	ōs	NULL	NULL
os:Dat.Pl	ōribus	ibus	ibus
osculum:Nom.Sg	osculum	um	um
osculum:Abl.Pl	osculīs	īs	īs
osculum:Dat.Sg	osculō	ō	ō
osculum:Acc.Pl	oscula	a	a
osculum:Gen.Sg	osculī	ī	ī
osculum:Gen.Pl	osculōrum	ōrum	ēs
osculum:Abl.Sg	osculō	ō	em
osculum:Nom.Pl	oscula	a	a
osculum:Acc.Sg	osculum	um	um
osculum:Dat.Pl	osculīs	īs	īs
otium:Nom.Sg	ōtium	um	um
otium:Abl.Pl	ōtiīs	īs	īs
otium:Dat.Sg	ōtiō	ō	ō
otium:Acc.Pl	ōtia	a	a
otium:Gen.Sg	ōtiī	ī	ī
otium:Gen.Pl	ōtiōrum	ōrum	ōrum
otium:Abl.Sg	ōtiō	ō	ō
otium:Nom.Pl	ōtia	a	a
otium:Acc.Sg	ōtium	um	um
otium:Dat.Pl	ōtiīs	īs	īs
palma:Nom.Sg	palma	a	a
palma:Abl.Pl	palmīs	īs	īs
palma:Dat.Sg	palmae	ae	ae
palma:Acc.Pl	palmās	ās	ās
palma:Gen.Sg	palmae	ae	a
palma:Gen.Pl	palmārum	ārum	ās
palma:Abl.Sg	palmā	ā	ās
palma:Nom.Pl	palmae	ae	a
palma:Acc.Sg	palmam	am	am
palma:Dat.Pl	palmīs	īs	īs
palus:Nom.Sg	palūs	NULL	NULL
palus:Abl.Pl	palūdibus	ibus	ibus
palus:Dat.Sg	palūdī	ī	ī
palus:Acc.Pl	palūdēs	ēs	ēs
palus:Gen.Sg	palūdis	is	is
palus:Gen.Pl	palūdum	um	um
palus:Abl.Sg	palūde	e	e
palus:Nom.Pl	palūdēs	ēs	ēs
palus:Acc.Sg	palūdem	em	em
palus:Dat.Pl	palūdibus	ibus	ibus
parens:Nom.Sg	parēns	NULL	NULL
parens:Abl.Pl	parentibus	ibus	ibus
parens:Dat.Sg	parentī	ī	ī
parens:Acc.Pl	parentēs	ēs	ēs
parens:Gen.Sg	parentis	is	is
parens:Gen.Pl	parentum	um	um
parens:Abl.Sg	parente	e	e
parens:Nom.Pl	parentēs	ēs	ēs
parens:Acc.Sg	parentem	em	em
parens:Dat.Pl	parentibus	ibus	ibus
pater:Nom.Sg	pater	NULL	em
pater:Abl.Pl	patribus	ibus	ibus
pater:Dat.Sg	patrī	ī	ī
pater:Acc.Pl	patrēs	ēs	ēs
pater:Gen.Sg	patris	is	is
pater:Gen.Pl	patrum	um	um
pater:Abl.Sg	patre	e	e
pater:Nom.Pl	patrēs	ēs	ēs
pater:Acc.Sg	patrem	em	em
pater:Dat.Pl	patribus	ibus	ibus
patria:Nom.Sg	patria	a	a
patria:Abl.Pl	patriīs	īs	īs
patria:Dat.Sg	patriae	ae	a
patria:Acc.Pl	patriās	ās	ās
patria:Gen.Sg	patriae	ae	a
patria:Gen.Pl	patriārum	ārum	ās
patria:Abl.Sg	patriā	ā	ās
patria:Nom.Pl	patriae	ae	a
patria:Acc.Sg	patriam	am	am
patria:Dat.Pl	patriīs	īs	īs
patruus:Nom.Sg	patruus	us	us
patruus:Abl.Pl	patruīs	īs	īs
patruus:Dat.Sg	patruō	ō	ō
patruus:Acc.Pl	patruōs	ōs	ōs
patruus:Gen.Sg	patruī	ī	ī
patruus:Gen.Pl	patruōrum	ōrum	ēs
patruus:Abl.Sg	patruō	ō	ō
patruus:Nom.Pl	patruī	ī	ī
patruus:Acc.Sg	patruum	um	ēs
patruus:Dat.Pl	patruīs	īs	īs
paupertas:Nom.Sg	paupertās	NULL	NULL
paupertas:Abl.Pl	paupertātibus	ibus	ibus
paupertas:Dat.Sg	paupertātī	ī	ī
paupertas:Acc.Pl	paupertātēs	ēs	ēs
paupertas:Gen.Sg	paupertātis	is	is
paupertas:Gen.Pl	paupertātum	um	um
paupertas:Abl.Sg	paupertāte	e	e
paupertas:Nom.Pl	paupertātēs	ēs	ēs
paupertas:Acc.Sg	paupertātem	em	em
paupertas:Dat.Pl	paupertātibus	ibus	ibus
pavor:Nom.Sg	pavor	NULL	NULL
pavor:Abl.Pl	pavōribus	ibus	ibus
pavor:Dat.Sg	pavōrī	ī	ī
pavor:Acc.Pl	pavōrēs	ēs	ēs
pavor:Gen.Sg	pavōris	is	is
pavor:Gen.Pl	pavōrum	um	um
pavor:Abl.Sg	pavōre	e	e
pavor:Nom.Pl	pavōrēs	ēs	ēs
pavor:Acc.Sg	pavōrem	em	em
pavor:Dat.Pl	pavōribus	ibus	ibus
pax:Nom.Sg	pāx	NULL	NULL
pax:Abl.Pl	pācibus	ibus	ibus
pax:Dat.Sg	pācī	ī	ī
pax:Acc.Pl	pācēs	ēs	ēs
pax:Gen.Sg	pācis	is	is
pax:Gen.Pl	pācum	um	um
pax:Abl.Sg	pāce	e	e
pax:Nom.Pl	pācēs	ēs	ēs
pax:Acc.Sg	pācem	em	em
pax:Dat.Pl	pācibus	ibus	ibus
pectus:Nom.Sg	pectus	NULL	NULL
pectus:Abl.Pl	pectoribus	ibus	ibus
pectus:Dat.Sg	pectorī	ī	ī
pectus:Acc.Pl	pectora	a	a
pectus:Gen.Sg	pectoris	is	is
pectus:Gen.Pl	pectorum	um	um
pectus:Abl.Sg	pectore	e	e
pectus:Nom.Pl	pectora	a	a
pectus:Acc.Sg	pectus	NULL	NULL
pectus:Dat.Pl	pectoribus	ibus	ibus
pecunia:Nom.Sg	pecūnia	a	a
pecunia:Abl.Pl	pecūniīs	īs	īs
pecunia:Dat.Sg	pecūniae	ae	a
pecunia:Acc.Pl	pecūniās	ās	ās
pecunia:Gen.Sg	pecūniae	ae	a
pecunia:Gen.Pl	pecūniārum	ārum	ōrum
pecunia:Abl.Sg	pecūniā	ā	ās
pecunia:Nom.Pl	pecūniae	ae	a
pecunia:Acc.Sg	pecūniam	am	ēs
pecunia:Dat.Pl	pecūniīs	īs	īs
pecus:Nom.Sg	pecus	NULL	NULL
pecus:Abl.Pl	pecoribus	ibus	ibus
pecus:Dat.Sg	pecorī	ī	ī
pecus:Acc.Pl	pecora	a	a
pecus:Gen.Sg	pecoris	is	is
pecus:Gen.Pl	pecorum	um	um
pecus:Abl.Sg	pecore	e	e
pecus:Nom.Pl	pecora	a	a
pecus:Acc.Sg	pecus	NULL	NULL
pecus:Dat.Pl	pecoribus	ibus	ibus
pellex:Nom.Sg	pellex	NULL	NULL
pellex:Abl.Pl	pellicibus	ibus	ibus
pellex:Dat.Sg	pellicī	ī	ī
pellex:Acc.Pl	pellicēs	ēs	ēs
pellex:Gen.Sg	pellicis	is	is
pellex:Gen.Pl	pellicum	um	um
pellex:Abl.Sg	pellice	e	e
pellex:Nom.Pl	pellicēs	ēs	ēs
pellex:Acc.Sg	pellicem	em	em
pellex:Dat.Pl	pellicibus	ibus	ibus
penas:Nom.Sg	penās	NULL	NULL
penas:Abl.Pl	penātibus	ibus	ibus
penas:Dat.Sg	penātī	ī	ī
penas:Acc.Pl	penātēs	ēs	ēs
penas:Gen.Sg	penātis	is	is
penas:Gen.Pl	penātum	um	um
penas:Abl.Sg	penāte	e	e
penas:Nom.Pl	penātēs	ēs	ēs
penas:Acc.Sg	penātem	em	em
penas:Dat.Pl	penātibus	ibus	ibus
periculum:Nom.Sg	perīculum	um	um
periculum:Abl.Pl	perīculīs	īs	īs
periculum:Dat.Sg	perīculō	ō	ō
periculum:Acc.Pl	perīcula	a	a
periculum:Gen.Sg	perīculī	ī	ī
periculum:Gen.Pl	perīculōrum	ōrum	ēs
periculum:Abl.Sg	perīculō	ō	ō
periculum:Nom.Pl	perīcula	a	a
periculum:Acc.Sg	perīculum	um	um
periculum:Dat.Pl	perīculīs	īs	īs
pes:Nom.Sg	pēs	NULL	NULL
pes:Abl.Pl	pedibus	ibus	ibus
pes:Dat.Sg	pedī	ī	ī
pes:Acc.Pl	pedēs	ēs	ēs
pes:Gen.Sg	pedis	is	is
pes:Gen.Pl	pedum	um	um
pes:Abl.Sg	pede	e	e
pes:Nom.Pl	pedēs	ēs	ēs
pes:Acc.Sg	pedem	em	em
pes:Dat.Pl	pedibus	ibus	ibus
pestis:Nom.Sg	pestis	is	īs
pestis:Abl.Pl	pestibus	ibus	ibus
pestis:Dat.Sg	pestī	ī	ī
pestis:Acc.Pl	pestēs	ēs	ēs
pestis:Gen.Sg	pestis	is	is
pestis:Gen.Pl	pestium	ium	ium
pestis:Abl.Sg	peste	e	e
pestis:Nom.Pl	pestēs	ēs	ēs
pestis:Acc.Sg	pestem	em	em
pestis:Dat.Pl	pestibus	ibus	ibus
pietas:Nom.Sg	pietās	NULL	NULL
pietas:Abl.Pl	pietātibus	ibus	ibus
pietas:Dat.Sg	pietātī	ī	ī
pietas:Acc.Pl	pietātēs	ēs	ēs
pietas:Gen.Sg	pietātis	is	is
pietas:Gen.Pl	pietātum	um	um
pietas:Abl.Sg	pietāte	e	e
pietas:Nom.Pl	pietātēs	ēs	ēs
pietas:Acc.Sg	pietātem	em	ēs
pietas:Dat.Pl	pietātibus	ibus	ibus
pignus:Nom.Sg	pignus	NULL	NULL
pignus:Abl.Pl	pignoribus	ibus	ibus
pignus:Dat.Sg	pignorī	ī	ū
pignus:Acc.Pl	pignora	a	a
pignus:Gen.Sg	pignoris	is	is
pignus:Gen.Pl	pignorum	um	um
pignus:Abl.Sg	pignore	e	e
pignus:Nom.Pl	pignora	a	a
pignus:Acc.Sg	pignus	NULL	NULL
pignus:Dat.Pl	pignoribus	ibus	ibus
poculum:Nom.Sg	pōculum	um	um
poculum:Abl.Pl	pōculīs	īs	īs
poculum:Dat.Sg	pōculō	ō	e
poculum:Acc.Pl	pōcula	a	a
poculum:Gen.Sg	pōculī	ī	ī
poculum:Gen.Pl	pōculōrum	ōrum	ēs
poculum:Abl.Sg	pōculō	ō	ō
poculum:Nom.Pl	pōcula	a	a
poculum:Acc.Sg	pōculum	um	um
poculum:Dat.Pl	pōculīs	īs	īs
poena:Nom.Sg	poena	a	a
poena:Abl.Pl	poenīs	īs	īs
poena:Dat.Sg	poenae	ae	ae
poena:Acc.Pl	poenās	ās	ās
poena:Gen.Sg	poenae	ae	a
poena:Gen.Pl	poenārum	ārum	ās
poena:Abl.Sg	poenā	ā	ā
poena:Nom.Pl	poenae	ae	a
poena:Acc.Sg	poenam	am	am
poena:Dat.Pl	poenīs	īs	īs
poeta:Nom.Sg	poēta	a	a
poeta:Abl.Pl	poētīs	īs	īs
poeta:Dat.Sg	poētae	ae	ae
poeta:Acc.Pl	poētās	ās	ās
poeta:Gen.Sg	poētae	ae	a
poeta:Gen.Pl	poētārum	ārum	ās
poeta:Abl.Sg	poētā	ā	ās
poeta:Nom.Pl	poētae	ae	a
poeta:Acc.Sg	poētam	am	am
poeta:Dat.Pl	poētīs	īs	īs
pondus:Nom.Sg	pondus	NULL	NULL
pondus:Abl.Pl	ponderibus	ibus	ibus
pondus:Dat.Sg	ponderī	ī	ī
pondus:Acc.Pl	pondera	a	a
pondus:Gen.Sg	ponderis	is	is
pondus:Gen.Pl	ponderum	um	um
pondus:Abl.Sg	pondere	e	e
pondus:Nom.Pl	pondera	a	a
pondus:Acc.Sg	pondus	NULL	NULL
pondus:Dat.Pl	ponderibus	ibus	ibus
pons:Nom.Sg	pōns	NULL	NULL
pons:Abl.Pl	pontibus	ibus	ibus
pons:Dat.Sg	pontī	ī	ī
pons:Acc.Pl	pontēs	ēs	ēs
pons:Gen.Sg	pontis	is	is
pons:Gen.Pl	pontium	ium	a
pons:Abl.Sg	ponte	e	e
pons:Nom.Pl	pontēs	ēs	ēs
pons:Acc.Sg	pontem	em	em
pons:Dat.Pl	pontibus	ibus	ibus
populus:Nom.Sg	populus	us	us
populus:Abl.Pl	populīs	īs	īs
populus:Dat.Sg	populō	ō	ō
populus:Acc.Pl	populōs	ōs	ōs
populus:Gen.Sg	populī	ī	ī
populus:Gen.Pl	populōrum	ōrum	ēs
populus:Abl.Sg	populō	ō	ō
populus:Nom.Pl	populī	ī	ī
populus:Acc.Sg	populum	um	um
populus:Dat.Pl	populīs	īs	īs
porta:Nom.Sg	porta	a	a
porta:Abl.Pl	portīs	īs	īs
porta:Dat.Sg	portae	ae	ae
porta:Acc.Pl	portās	ās	ās
porta:Gen.Sg	portae	ae	ae
porta:Gen.Pl	portārum	ārum	ā
porta:Abl.Sg	portā	ā	ā
porta:Nom.Pl	portae	ae	a
porta:Acc.Sg	portam	am	am
porta:Dat.Pl	portīs	īs	īs
portus:Nom.Sg	portus	us	us
portus:Abl.Pl	portibus	ibus	ibus
portus:Dat.Sg	portuī	uī	um
portus:Acc.Pl	portūs	ūs	us
portus:Gen.Sg	portūs	ūs	ūs
portus:Gen.Pl	portuum	uum	ēs
portus:Abl.Sg	portū	ū	ū
portus:Nom.Pl	portūs	ūs	us
portus:Acc.Sg	portum	um	um
portus:Dat.Pl	portibus	ibus	ibus
praeceptum:Nom.Sg	praeceptum	um	um
praeceptum:Abl.Pl	praeceptīs	īs	a
praeceptum:Dat.Sg	praeceptō	ō	ō
praeceptum:Acc.Pl	praecepta	a	a
praeceptum:Gen.Sg	praeceptī	ī	ī
praeceptum:Gen.Pl	praeceptōrum	ōrum	ēs
praeceptum:Abl.Sg	praeceptō	ō	ō
praeceptum:Nom.Pl	praecepta	a	a
praeceptum:Acc.Sg	praeceptum	um	um
praeceptum:Dat.Pl	praeceptīs	īs	a
praeda:Nom.Sg	praeda	a	a
praeda:Abl.Pl	praedīs	īs	īs
praeda:Dat.Sg	praedae	ae	a
praeda:Acc.Pl	praedās	ās	ās
praeda:Gen.Sg	praedae	ae	a
praeda:Gen.Pl	praedārum	ārum	ās
praeda:Abl.Sg	praedā	ā	ā
praeda:Nom.Pl	praedae	ae	a
praeda:Acc.Sg	praedam	am	am
praeda:Dat.Pl	praedīs	īs	īs
praemium:Nom.Sg	praemium	um	um
praemium:Abl.Pl	praemiīs	īs	īs
praemium:Dat.Sg	praemiō	ō	ō
praemium:Acc.Pl	praemia	a	a
praemium:Gen.Sg	praemiī	ī	ī
praemium:Gen.Pl	praemiōrum	ōrum	ōrum
praemium:Abl.Sg	praemiō	ō	em
praemium:Nom.Pl	praemia	a	a
praemium:Acc.Sg	praemium	um	um
praemium:Dat.Pl	praemiīs	īs	īs
praesidium:Nom.Sg	praesidium	um	ēs
praesidium:Abl.Pl	praesidiīs	īs	īs
praesidium:Dat.Sg	praesidiō	ō	e
praesidium:Acc.Pl	praesidia	a	a
praesidium:Gen.Sg	praesidiī	ī	ī
praesidium:Gen.Pl	praesidiōrum	ōrum	ōrum
praesidium:Abl.Sg	praesidiō	ō	ō
praesidium:Nom.Pl	praesidia	a	a
praesidium:Acc.Sg	praesidium	um	ēs
praesidium:Dat.Pl	praesidiīs	īs	īs
praetor:Nom.Sg	praetōr	NULL	NULL
praetor:Abl.Pl	praetōribus	ibus	ibus
praetor:Dat.Sg	praetōrī	ī	ī
praetor:Acc.Pl	praetōrēs	ēs	ēs
praetor:Gen.Sg	praetōris	is	is
praetor:Gen.Pl	praetōrum	um	um
praetor:Abl.Sg	praetōre	e	e
praetor:Nom.Pl	praetōrēs	ēs	ēs
praetor:Acc.Sg	praetōrem	em	em
praetor:Dat.Pl	praetōribus	ibus	ibus
pretium:Nom.Sg	pretium	um	um
pretium:Abl.Pl	pretiīs	īs	īs
pretium:Dat.Sg	pretiō	ō	ō
pretium:Acc.Pl	pretia	a	a
pretium:Gen.Sg	pretiī	ī	ī
pretium:Gen.Pl	pretiōrum	ōrum	ēs
pretium:Abl.Sg	pretiō	ō	em
pretium:Nom.Pl	pretia	a	a
pretium:Acc.Sg	pretium	um	um
pretium:Dat.Pl	pretiīs	īs	īs
prex:Nom.Sg	prex	NULL	NULL
prex:Abl.Pl	precibus	ibus	ibus
prex:Dat.Sg	precī	ī	ī
prex:Acc.Pl	precēs	ēs	ēs
prex:Gen.Sg	precis	is	is
prex:Gen.Pl	precum	um	ēs
prex:Abl.Sg	prece	e	e
prex:Nom.Pl	precēs	ēs	ēs
prex:Acc.Sg	precem	em	em
prex:Dat.Pl	precibus	ibus	ibus
princeps:Nom.Sg	prīnceps	NULL	NULL
princeps:Abl.Pl	prīncipibus	ibus	ibus
princeps:Dat.Sg	prīncipī	ī	ī
princeps:Acc.Pl	prīncipēs	ēs	ēs
princeps:Gen.Sg	prīncipis	is	is
princeps:Gen.Pl	prīncipum	um	um
princeps:Abl.Sg	prīncipe	e	e
princeps:Nom.Pl	prīncipēs	ēs	ēs
princeps:Acc.Sg	prīncipem	em	em
princeps:Dat.Pl	prīncipibus	ibus	ibus
principium:Nom.Sg	prīncipium	um	um
principium:Abl.Pl	prīncipiīs	īs	īs
principium:Dat.Sg	prīncipiō	ō	ō
principium:Acc.Pl	prīncipia	a	a
principium:Gen.Sg	prīncipiī	ī	uī
principium:Gen.Pl	prīncipiōrum	ōrum	ōrum
principium:Abl.Sg	prīncipiō	ō	ō
principium:Nom.Pl	prīncipia	a	a
principium:Acc.Sg	prīncipium	um	um
principium:Dat.Pl	prīncipiīs	īs	īs
proelium:Nom.Sg	proelium	um	um
proelium:Abl.Pl	proeliīs	īs	īs
proelium:Dat.Sg	proeliō	ō	ō
proelium:Acc.Pl	proelia	a	a
proelium:Gen.Sg	proeliī	ī	ī
proelium:Gen.Pl	proeliōrum	ōrum	ēs
proelium:Abl.Sg	proeliō	ō	em
proelium:Nom.Pl	proelia	a	a
proelium:Acc.Sg	proelium	um	um
proelium:Dat.Pl	proeliīs	īs	īs
pudor:Nom.Sg	pudor	NULL	NULL
pudor:Abl.Pl	pudōribus	ibus	ibus
pudor:Dat.Sg	pudōrī	ī	ī
pudor:Acc.Pl	pudōrēs	ēs	ēs
pudor:Gen.Sg	pudōris	is	is
pudor:Gen.Pl	pudōrum	um	um
pudor:Abl.Sg	pudōre	e	e
pudor:Nom.Pl	pudōrēs	ēs	ēs
pudor:Acc.Sg	pudōrem	em	em
pudor:Dat.Pl	pudōribus	ibus	ibus
puella:Nom.Sg	puella	a	a
puella:Abl.Pl	puellīs	īs	īs
puella:Dat.Sg	puellae	ae	a
puella:Acc.Pl	puellās	ās	ās
puella:Gen.Sg	puellae	ae	a
puella:Gen.Pl	puellārum	ārum	ās
puella:Abl.Sg	puellā	ā	ās
puella:Nom.Pl	puellae	ae	a
puella:Acc.Sg	puellam	am	ōrum
puella:Dat.Pl	puellīs	īs	īs
puer:Nom.Sg	puer	NULL	NULL
puer:Abl.Pl	puerīs	īs	īs
puer:Dat.Sg	puerō	ō	ō
puer:Acc.Pl	puerōs	ōs	ūs
puer:Gen.Sg	puerī	ī	ī
puer:Gen.Pl	puerōrum	ōrum	ēs
puer:Abl.Sg	puerō	ō	ō
puer:Nom.Pl	puerī	ī	ī
puer:Acc.Sg	puerum	um	um
puer:Dat.Pl	puerīs	īs	īs
pugna:Nom.Sg	pugna	a	a
pugna:Abl.Pl	pugnīs	īs	īs
pugna:Dat.Sg	pugnae	ae	a
pugna:Acc.Pl	pugnās	ās	am
pugna:Gen.Sg	pugnae	ae	a
pugna:Gen.Pl	pugnārum	ārum	am
pugna:Abl.Sg	pugnā	ā	ā
pugna:Nom.Pl	pugnae	ae	a
pugna:Acc.Sg	pugnam	am	ōrum
pugna:Dat.Pl	pugnīs	īs	īs
pulvis:Nom.Sg	pulvis	NULL	NULL
pulvis:Abl.Pl	pulveribus	ibus	ibus
pulvis:Dat.Sg	pulverī	ī	ī
pulvis:Acc.Pl	pulverēs	ēs	ēs
pulvis:Gen.Sg	pulveris	is	is
pulvis:Gen.Pl	pulverum	um	um
pulvis:Abl.Sg	pulvere	e	e
pulvis:Nom.Pl	pulverēs	ēs	ēs
pulvis:Acc.Sg	pulverem	em	em
pulvis:Dat.Pl	pulveribus	ibus	ibus
puppis:Nom.Sg	puppis	is	a
puppis:Abl.Pl	puppibus	ibus	ibus
puppis:Dat.Sg	puppī	ī	ī
puppis:Acc.Pl	puppēs	ēs	ēs
puppis:Gen.Sg	puppis	is	ae
puppis:Gen.Pl	puppium	ium	ium
puppis:Abl.Sg	puppe	e	e
puppis:Nom.Pl	puppēs	ēs	ēs
puppis:Acc.Sg	puppem	em	em
puppis:Dat.Pl	puppibus	ibus	ibus
querela:Nom.Sg	querēla	a	a
querela:Abl.Pl	querēlīs	īs	īs
querela:Dat.Sg	querēlae	ae	es
querela:Acc.Pl	querēlās	ās	ās
querela:Gen.Sg	querēlae	ae	es
querela:Gen.Pl	querēlārum	ārum	ā
querela:Abl.Sg	querēlā	ā	ā
querela:Nom.Pl	querēlae	ae	es
querela:Acc.Sg	querēlam	am	ās
querela:Dat.Pl	querēlīs	īs	īs
quies:Nom.Sg	quiēs	NULL	NULL
quies:Abl.Pl	quiētibus	ibus	ibus
quies:Dat.Sg	quiētī	ī	ī
quies:Acc.Pl	quiētēs	ēs	ēs
quies:Gen.Sg	quiētis	is	is
quies:Gen.Pl	quiētum	um	um
quies:Abl.Sg	quiēte	e	e
quies:Nom.Pl	quiētēs	ēs	ēs
quies:Acc.Sg	quiētem	em	ēs
quies:Dat.Pl	quiētibus	ibus	ibus
radius:Nom.Sg	radius	us	us
radius:Abl.Pl	radiīs	īs	īs
radius:Dat.Sg	radiō	ō	ō
radius:Acc.Pl	radiōs	ōs	ōs
radius:Gen.Sg	radiī	ī	ī
radius:Gen.Pl	radiōrum	ōrum	ēs
radius:Abl.Sg	radiō	ō	ō
radius:Nom.Pl	radiī	ī	ī
radius:Acc.Sg	radium	um	um
radius:Dat.Pl	radiīs	īs	īs
radix:Nom.Sg	rādīx	NULL	NULL
radix:Abl.Pl	rādīcibus	ibus	ibus
radix:Dat.Sg	rādīcī	ī	ī
radix:Acc.Pl	rādīcēs	ēs	ēs
radix:Gen.Sg	rādīcis	is	is
radix:Gen.Pl	rādīcum	um	um
radix:Abl.Sg	rādīce	e	e
radix:Nom.Pl	rādīcēs	ēs	ēs
radix:Acc.Sg	rādīcem	em	em
radix:Dat.Pl	rādīcibus	ibus	ibus
ramus:Nom.Sg	rāmus	us	us
ramus:Abl.Pl	rāmīs	īs	īs
ramus:Dat.Sg	rāmō	ō	ō
ramus:Acc.Pl	rāmōs	ōs	ūs
ramus:Gen.Sg	rāmī	ī	ī
ramus:Gen.Pl	rāmōrum	ōrum	ēs
ramus:Abl.Sg	rāmō	ō	ō
ramus:Nom.Pl	rāmī	ī	ī
ramus:Acc.Sg	rāmum	um	um
ramus:Dat.Pl	rāmīs	īs	īs
ratio:Nom.Sg	ratiō	NULL	NULL
ratio:Abl.Pl	ratiōnibus	ibus	ibus
ratio:Dat.Sg	ratiōnī	ī	ī
ratio:Acc.Pl	ratiōnēs	ēs	ēs
ratio:Gen.Sg	ratiōnis	is	is
ratio:Gen.Pl	ratiōnum	um	ēs
ratio:Abl.Sg	ratiōne	e	e
ratio:Nom.Pl	ratiōnēs	ēs	ēs
ratio:Acc.Sg	ratiōnem	em	em
ratio:Dat.Pl	ratiōnibus	ibus	ibus
ratis:Nom.Sg	ratis	is	īs
ratis:Abl.Pl	ratibus	ibus	ibus
ratis:Dat.Sg	ratī	ī	ī
ratis:Acc.Pl	ratēs	ēs	ēs
ratis:Gen.Sg	ratis	is	is
ratis:Gen.Pl	ratum	um	um
ratis:Abl.Sg	rate	e	e
ratis:Nom.Pl	ratēs	ēs	ēs
ratis:Acc.Sg	ratem	em	em
ratis:Dat.Pl	ratibus	ibus	ibus
rector:Nom.Sg	rector	NULL	NULL
rector:Abl.Pl	rectōribus	ibus	ibus
rector:Dat.Sg	rectōrī	ī	ī
rector:Acc.Pl	rectōrēs	ēs	ēs
rector:Gen.Sg	rectōris	is	is
rector:Gen.Pl	rectōrum	um	um
rector:Abl.Sg	rectōre	e	e
rector:Nom.Pl	rectōrēs	ēs	ēs
rector:Acc.Sg	rectōrem	em	em
rector:Dat.Pl	rectōribus	ibus	ibus
regia:Nom.Sg	rēgia	a	a
regia:Abl.Pl	rēgiīs	īs	īs
regia:Dat.Sg	rēgiae	ae	es
regia:Acc.Pl	rēgiās	ās	ās
regia:Gen.Sg	rēgiae	ae	es
regia:Gen.Pl	rēgiārum	ārum	ā
regia:Abl.Sg	rēgiā	ā	ā
regia:Nom.Pl	rēgiae	ae	es
regia:Acc.Sg	rēgiam	am	ās
regia:Dat.Pl	rēgiīs	īs	īs
regina:Nom.Sg	rēgīna	a	a
regina:Abl.Pl	rēgīnīs	īs	īs
regina:Dat.Sg	rēgīnae	ae	ae
regina:Acc.Pl	rēgīnās	ās	ās
regina:Gen.Sg	rēgīnae	ae	ae
regina:Gen.Pl	rēgīnārum	ārum	ā
regina:Abl.Sg	rēgīnā	ā	ā
regina:Nom.Pl	rēgīnae	ae	a
regina:Acc.Sg	rēgīnam	am	ās
regina:Dat.Pl	rēgīnīs	īs	īs
regio:Nom.Sg	regiō	NULL	NULL
regio:Abl.Pl	regiōnibus	ibus	ibus
regio:Dat.Sg	regiōnī	ī	ī
regio:Acc.Pl	regiōnēs	ēs	ēs
regio:Gen.Sg	regiōnis	is	is
regio:Gen.Pl	regiōnum	um	um
regio:Abl.Sg	regiōne	e	e
regio:Nom.Pl	regiōnēs	ēs	ēs
regio:Acc.Sg	regiōnem	em	em
regio:Dat.Pl	regiōnibus	ibus	ibus
regnum:Nom.Sg	rēgnum	um	um
regnum:Abl.Pl	rēgnīs	īs	īs
regnum:Dat.Sg	rēgnō	ō	ō
regnum:Acc.Pl	rēgna	a	a
regnum:Gen.Sg	rēgnī	ī	ī
regnum:Gen.Pl	rēgnōrum	ōrum	ēs
regnum:Abl.Sg	rēgnō	ō	em
regnum:Nom.Pl	rēgna	a	a
regnum:Acc.Sg	rēgnum	um	um
regnum:Dat.Pl	rēgnīs	īs	īs
remus:Nom.Sg	rēmus	us	us
remus:Abl.Pl	rēmīs	īs	īs
remus:Dat.Sg	rēmō	ō	ō
remus:Acc.Pl	rēmōs	ōs	ōs
remus:Gen.Sg	rēmī	ī	ī
remus:Gen.Pl	rēmōrum	ōrum	ēs
remus:Abl.Sg	rēmō	ō	ō
remus:Nom.Pl	rēmī	ī	ī
remus:Acc.Sg	rēmum	um	um
remus:Dat.Pl	rēmīs	īs	īs
res:Nom.Sg	rēs	ēs	ēs
res:Abl.Pl	rēbus	ēbus	ēs
res:Dat.Sg	reī	eī	a
res:Acc.Pl	rēs	ēs	ēs
res:Gen.Sg	reī	eī	a
res:Gen.Pl	rērum	ērum	ēs
res:Abl.Sg	rē	ē	em
res:Nom.Pl	rēs	ēs	ēs
res:Acc.Sg	rem	em	em
res:Dat.Pl	rēbus	ēbus	ēs
rex:Nom.Sg	rēx	NULL	NULL
rex:Abl.Pl	rēgibus	ibus	ibus
rex:Dat.Sg	rēgī	ī	ī
rex:Acc.Pl	rēgēs	ēs	ēs
rex:Gen.Sg	rēgis	is	is
rex:Gen.Pl	rēgum	um	um
rex:Abl.Sg	rēge	e	e
rex:Nom.Pl	rēgēs	ēs	ēs
rex:Acc.Sg	rēgem	em	em
rex:Dat.Pl	rēgibus	ibus	ibus
ripa:Nom.Sg	rīpa	a	a
ripa:Abl.Pl	rīpīs	īs	īs
ripa:Dat.Sg	rīpae	ae	ae
ripa:Acc.Pl	rīpās	ās	ās
ripa:Gen.Sg	rīpae	ae	a
ripa:Gen.Pl	rīpārum	ārum	ā
ripa:Abl.Sg	rīpā	ā	ā
ripa:Nom.Pl	rīpae	ae	a
ripa:Acc.Sg	rīpam	am	am
ripa:Dat.Pl	rīpīs	īs	īs
robur:Nom.Sg	rōbur	NULL	NULL
robur:Abl.Pl	rōboribus	ibus	ibus
robur:Dat.Sg	rōborī	ī	ī
robur:Acc.Pl	rōbora	a	a
robur:Gen.Sg	rōboris	is	is
robur:Gen.Pl	rōborum	um	um
robur:Abl.Sg	rōbore	e	e
robur:Nom.Pl	rōbora	a	a
robur:Acc.Sg	rōbur	NULL	NULL
robur:Dat.Pl	rōboribus	ibus	ibus
rogus:Nom.Sg	rogus	us	us
rogus:Abl.Pl	rogīs	īs	īs
rogus:Dat.Sg	rogō	ō	ō
rogus:Acc.Pl	rogōs	ōs	ōs
rogus:Gen.Sg	rogī	ī	ī
rogus:Gen.Pl	rogōrum	ōrum	ēs
rogus:Abl.Sg	rogō	ō	ō
rogus:Nom.Pl	rogī	ī	ī
rogus:Acc.Sg	rogum	um	um
rogus:Dat.Pl	rogīs	īs	īs
rota:Nom.Sg	rota	a	a
rota:Abl.Pl	rotīs	īs	īs
rota:Dat.Sg	rotae	ae	ae
rota:Acc.Pl	rotās	ās	ās
rota:Gen.Sg	rotae	ae	a
rota:Gen.Pl	rotārum	ārum	ā
rota:Abl.Sg	rotā	ā	ā
rota:Nom.Pl	rotae	ae	a
rota:Acc.Sg	rotam	am	am
rota:Dat.Pl	rotīs	īs	īs
ruina:Nom.Sg	ruīna	a	a
ruina:Abl.Pl	ruīnīs	īs	īs
ruina:Dat.Sg	ruīnae	ae	ae
ruina:Acc.Pl	ruīnās	ās	ās
ruina:Gen.Sg	ruīnae	ae	a
ruina:Gen.Pl	ruīnārum	ārum	ā
ruina:Abl.Sg	ruīnā	ā	ā
ruina:Nom.Pl	ruīnae	ae	a
ruina:Acc.Sg	ruīnam	am	am
ruina:Dat.Pl	ruīnīs	īs	īs
rumor:Nom.Sg	rūmor	NULL	NULL
rumor:Abl.Pl	rūmōribus	ibus	ibus
rumor:Dat.Sg	rūmōrī	ī	ī
rumor:Acc.Pl	rūmōrēs	ēs	ēs
rumor:Gen.Sg	rūmōris	is	is
rumor:Gen.Pl	rūmōrum	um	um
rumor:Abl.Sg	rūmōre	e	e
rumor:Nom.Pl	rūmōrēs	ēs	ēs
rumor:Acc.Sg	rūmōrem	em	em
rumor:Dat.Pl	rūmōribus	ibus	ibus
rupes:Nom.Sg	rūpēs	ēs	ēs
rupes:Abl.Pl	rūpibus	ibus	ibus
rupes:Dat.Sg	rūpī	ī	ī
rupes:Acc.Pl	rūpēs	ēs	ēs
rupes:Gen.Sg	rūpis	is	is
rupes:Gen.Pl	rūpium	ium	ium
rupes:Abl.Sg	rūpe	e	e
rupes:Nom.Pl	rūpēs	ēs	ēs
rupes:Acc.Sg	rūpem	em	em
rupes:Dat.Pl	rūpibus	ibus	ibus
rus:Nom.Sg	rūs	NULL	NULL
rus:Abl.Pl	rūribus	ibus	ibus
rus:Dat.Sg	rūrī	ī	ī
rus:Acc.Pl	rūra	a	a
rus:Gen.Sg	rūris	is	is
rus:Gen.Pl	rūrum	um	um
rus:Abl.Sg	rūre	e	e
rus:Nom.Pl	rūra	a	a
rus:Acc.Sg	rūs	NULL	NULL
rus:Dat.Pl	rūribus	ibus	ibus
sacerdos:Nom.Sg	sacerdōs	NULL	NULL
sacerdos:Abl.Pl	sacerdōtibus	ibus	ibus
sacerdos:Dat.Sg	sacerdōtī	ī	ī
sacerdos:Acc.Pl	sacerdōtēs	ēs	ēs
sacerdos:Gen.Sg	sacerdōtis	is	is
sacerdos:Gen.Pl	sacerdōtum	um	um
sacerdos:Abl.Sg	sacerdōte	e	e
sacerdos:Nom.Pl	sacerdōtēs	ēs	ēs
sacerdos:Acc.Sg	sacerdōtem	em	em
sacerdos:Dat.Pl	sacerdōtibus	ibus	ibus
sacrum:Nom.Sg	sacrum	um	um
sacrum:Abl.Pl	sacrīs	īs	īs
sacrum:Dat.Sg	sacrō	ō	ō
sacrum:Acc.Pl	sacra	a	a
sacrum:Gen.Sg	sacrī	ī	ī
sacrum:Gen.Pl	sacrōrum	ōrum	ēs
sacrum:Abl.Sg	sacrō	ō	ō
sacrum:Nom.Pl	sacra	a	a
sacrum:Acc.Sg	sacrum	um	um
sacrum:Dat.Pl	sacrīs	īs	īs
saeculum:Nom.Sg	saeculum	um	um
saeculum:Abl.Pl	saeculīs	īs	īs
saeculum:Dat.Sg	saeculō	ō	ō
saeculum:Acc.Pl	saecula	a	a
saeculum:Gen.Sg	saeculī	ī	ī
saeculum:Gen.Pl	saeculōrum	ōrum	ēs
saeculum:Abl.Sg	saeculō	ō	ō
saeculum:Nom.Pl	saecula	a	a
saeculum:Acc.Sg	saeculum	um	um
saeculum:Dat.Pl	saeculīs	īs	īs
sagitta:Nom.Sg	sagitta	a	a
sagitta:Abl.Pl	sagittīs	īs	a
sagitta:Dat.Sg	sagittae	ae	ae
sagitta:Acc.Pl	sagittās	ās	ās
sagitta:Gen.Sg	sagittae	ae	a
sagitta:Gen.Pl	sagittārum	ārum	ā
sagitta:Abl.Sg	sagittā	ā	ā
sagitta:Nom.Pl	sagittae	ae	a
sagitta:Acc.Sg	sagittam	am	am
sagitta:Dat.Pl	sagittīs	īs	īs
saltus:Nom.Sg	saltus	us	us
saltus:Abl.Pl	saltibus	ibus	ibus
saltus:Dat.Sg	saltuī	uī	um
saltus:Acc.Pl	saltūs	ūs	us
saltus:Gen.Sg	saltūs	ūs	ūs
saltus:Gen.Pl	saltuum	uum	ēs
saltus:Abl.Sg	saltū	ū	ū
saltus:Nom.Pl	saltūs	ūs	us
saltus:Acc.Sg	saltum	um	um
saltus:Dat.Pl	saltibus	ibus	ibus
salus:Nom.Sg	salūs	NULL	NULL
salus:Abl.Pl	salūtibus	ibus	ibus
salus:Dat.Sg	salūtī	ī	ī
salus:Acc.Pl	salūtēs	ēs	ēs
salus:Gen.Sg	salūtis	is	is
salus:Gen.Pl	salūtum	um	um
salus:Abl.Sg	salūte	e	e
salus:Nom.Pl	salūtēs	ēs	ēs
salus:Acc.Sg	salūtem	em	em
salus:Dat.Pl	salūtibus	ibus	ibus
sanctus:Nom.Sg	sānctus	us	a
sanctus:Abl.Pl	sānctīs	īs	īs
sanctus:Dat.Sg	sānctō	ō	em
sanctus:Acc.Pl	sānctōs	ōs	ēs
sanctus:Gen.Sg	sānctī	ī	ī
sanctus:Gen.Pl	sānctōrum	ōrum	ēs
sanctus:Abl.Sg	sānctō	ō	em
sanctus:Nom.Pl	sānctī	ī	ī
sanctus:Acc.Sg	sānctum	um	um
sanctus:Dat.Pl	sānctīs	īs	īs
sanguis:Nom.Sg	sanguis	NULL	NULL
sanguis:Abl.Pl	sanguinibus	ibus	ibus
sanguis:Dat.Sg	sanguinī	ī	ī
sanguis:Acc.Pl	sanguinēs	ēs	ēs
sanguis:Gen.Sg	sanguinis	is	is
sanguis:Gen.Pl	sanguinum	um	ēs
sanguis:Abl.Sg	sanguine	e	e
sanguis:Nom.Pl	sanguinēs	ēs	ēs
sanguis:Acc.Sg	sanguinem	em	em
sanguis:Dat.Pl	sanguinibus	ibus	ibus
saxum:Nom.Sg	saxum	um	um
saxum:Abl.Pl	saxīs	īs	a
saxum:Dat.Sg	saxō	ō	ō
saxum:Acc.Pl	saxa	a	a
saxum:Gen.Sg	saxī	ī	ī
saxum:Gen.Pl	saxōrum	ōrum	ēs
saxum:Abl.Sg	saxō	ō	ō
saxum:Nom.Pl	saxa	a	a
saxum:Acc.Sg	saxum	um	um
saxum:Dat.Pl	saxīs	īs	a
scelus:Nom.Sg	scelus	NULL	NULL
scelus:Abl.Pl	sceleribus	ibus	ibus
scelus:Dat.Sg	scelerī	ī	ī
scelus:Acc.Pl	scelera	a	a
scelus:Gen.Sg	sceleris	is	is
scelus:Gen.Pl	scelerum	um	um
scelus:Abl.Sg	scelere	e	e
scelus:Nom.Pl	scelera	a	a
scelus:Acc.Sg	scelus	NULL	NULL
scelus:Dat.Pl	sceleribus	ibus	ibus
sedes:Nom.Sg	sēdēs	ēs	ēs
sedes:Abl.Pl	sēdibus	ibus	ibus
sedes:Dat.Sg	sēdī	ī	ī
sedes:Acc.Pl	sēdēs	ēs	ēs
sedes:Gen.Sg	sēdis	is	is
sedes:Gen.Pl	sēdium	ium	ēbus
sedes:Abl.Sg	sēde	e	e
sedes:Nom.Pl	sēdēs	ēs	ēs
sedes:Acc.Sg	sēdem	em	em
sedes:Dat.Pl	sēdibus	ibus	ibus
seges:Nom.Sg	seges	NULL	NULL
seges:Abl.Pl	segetibus	ibus	ibus
seges:Dat.Sg	segetī	ī	ī
seges:Acc.Pl	segetēs	ēs	ēs
seges:Gen.Sg	segetis	is	is
seges:Gen.Pl	segetum	um	um
seges:Abl.Sg	segete	e	e
seges:Nom.Pl	segetēs	ēs	ēs
seges:Acc.Sg	segetem	em	em
seges:Dat.Pl	segetibus	ibus	ibus
semen:Nom.Sg	sēmen	NULL	NULL
semen:Abl.Pl	sēminibus	ibus	ibus
semen:Dat.Sg	sēminī	ī	ī
semen:Acc.Pl	sēmina	a	a
semen:Gen.Sg	sēminis	is	is
semen:Gen.Pl	sēminum	um	um
semen:Abl.Sg	sēmine	e	e
semen:Nom.Pl	sēmina	a	a
semen:Acc.Sg	sēmen	NULL	NULL
semen:Dat.Pl	sēminibus	ibus	ibus
senectus:Nom.Sg	senectūs	NULL	NULL
senectus:Abl.Pl	senectūtibus	ibus	ibus
senectus:Dat.Sg	senectūtī	ī	ī
senectus:Acc.Pl	senectūtēs	ēs	ēs
senectus:Gen.Sg	senectūtis	is	is
senectus:Gen.Pl	senectūtum	um	um
senectus:Abl.Sg	senectūte	e	e
senectus:Nom.Pl	senectūtēs	ēs	ēs
senectus:Acc.Sg	senectūtem	em	em
senectus:Dat.Pl	senectūtibus	ibus	ibus
senex:Nom.Sg	senex	NULL	e
senex:Abl.Pl	senibus	ibus	ibus
senex:Dat.Sg	senī	ī	ī
senex:Acc.Pl	senēs	ēs	ēs
senex:Gen.Sg	senis	is	is
senex:Gen.Pl	senum	um	um
senex:Abl.Sg	sene	e	e
senex:Nom.Pl	senēs	ēs	ēs
senex:Acc.Sg	senem	em	em
senex:Dat.Pl	senibus	ibus	ibus
sensus:Nom.Sg	sēnsus	us	us
sensus:Abl.Pl	sēnsibus	ibus	ibus
sensus:Dat.Sg	sēnsuī	uī	um
sensus:Acc.Pl	sēnsūs	ūs	us
sensus:Gen.Sg	sēnsūs	ūs	ūs
sensus:Gen.Pl	sēnsuum	uum	ēs
sensus:Abl.Sg	sēnsū	ū	ū
sensus:Nom.Pl	sēnsūs	ūs	us
sensus:Acc.Sg	sēnsum	um	um
sensus:Dat.Pl	sēnsibus	ibus	ibus
sententia:Nom.Sg	sententia	a	a
sententia:Abl.Pl	sententiīs	īs	a
sententia:Dat.Sg	sententiae	ae	a
sententia:Acc.Pl	sententiās	ās	ās
sententia:Gen.Sg	sententiae	ae	a
sententia:Gen.Pl	sententiārum	ārum	ōrum
sententia:Abl.Sg	sententiā	ā	ās
sententia:Nom.Pl	sententiae	ae	a
sententia:Acc.Sg	sententiam	am	am
sententia:Dat.Pl	sententiīs	īs	a
sepulcrum:Nom.Sg	sepulcrum	um	um
sepulcrum:Abl.Pl	sepulcrīs	īs	īs
sepulcrum:Dat.Sg	sepulcrō	ō	ō
sepulcrum:Acc.Pl	sepulcra	a	a
sepulcrum:Gen.Sg	sepulcrī	ī	ī
sepulcrum:Gen.Pl	sepulcrōrum	ōrum	ēs
sepulcrum:Abl.Sg	sepulcrō	ō	em
sepulcrum:Nom.Pl	sepulcra	a	a
sepulcrum:Acc.Sg	sepulcrum	um	um
sepulcrum:Dat.Pl	sepulcrīs	īs	īs
sermo:Nom.Sg	sermō	NULL	NULL
sermo:Abl.Pl	sermōnibus	ibus	ibus
sermo:Dat.Sg	sermōnī	ī	ī
sermo:Acc.Pl	sermōnēs	ēs	ēs
sermo:Gen.Sg	sermōnis	is	is
sermo:Gen.Pl	sermōnum	um	um
sermo:Abl.Sg	sermōne	e	e
sermo:Nom.Pl	sermōnēs	ēs	ēs
sermo:Acc.Sg	sermōnem	em	em
sermo:Dat.Pl	sermōnibus	ibus	ibus
serpens:Nom.Sg	serpēns	NULL	NULL
serpens:Abl.Pl	serpentibus	ibus	ibus
serpens:Dat.Sg	serpentī	ī	ī
serpens:Acc.Pl	serpentēs	ēs	ēs
serpens:Gen.Sg	serpentis	is	is
serpens:Gen.Pl	serpentum	um	um
serpens:Abl.Sg	serpente	e	e
serpens:Nom.Pl	serpentēs	ēs	ēs
serpens:Acc.Sg	serpentem	em	em
serpens:Dat.Pl	serpentibus	ibus	ibus
servitium:Nom.Sg	servitium	um	um
servitium:Abl.Pl	servitiīs	īs	īs
servitium:Dat.Sg	servitiō	ō	ō
servitium:Acc.Pl	servitia	a	a
servitium:Gen.Sg	servitiī	ī	ī
servitium:Gen.Pl	servitiōrum	ōrum	ēs
servitium:Abl.Sg	servitiō	ō	ō
servitium:Nom.Pl	servitia	a	a
servitium:Acc.Sg	servitium	um	um
servitium:Dat.Pl	servitiīs	īs	īs
servus:Nom.Sg	servus	us	us
servus:Abl.Pl	servīs	īs	īs
servus:Dat.Sg	servō	ō	e
servus:Acc.Pl	servōs	ōs	ōs
servus:Gen.Sg	servī	ī	ī
servus:Gen.Pl	servōrum	ōrum	ēs
servus:Abl.Sg	servō	ō	ō
servus:Nom.Pl	servī	ī	ī
servus:Acc.Sg	servum	um	um
servus:Dat.Pl	servīs	īs	īs
sidus:Nom.Sg	sīdus	NULL	NULL
sidus:Abl.Pl	sīderibus	ibus	ibus
sidus:Dat.Sg	sīderī	ī	ī
sidus:Acc.Pl	sīdera	a	a
sidus:Gen.Sg	sīderis	is	is
sidus:Gen.Pl	sīderum	um	um
sidus:Abl.Sg	sīdere	e	e
sidus:Nom.Pl	sīdera	a	a
sidus:Acc.Sg	sīdus	NULL	NULL
sidus:Dat.Pl	sīderibus	ibus	ibus
signum:Nom.Sg	signum	um	um
signum:Abl.Pl	signīs	īs	īs
signum:Dat.Sg	signō	ō	ō
signum:Acc.Pl	signa	a	a
signum:Gen.Sg	signī	ī	ī
signum:Gen.Pl	signōrum	ōrum	ēs
signum:Abl.Sg	signō	ō	em
signum:Nom.Pl	signa	a	a
signum:Acc.Sg	signum	um	um
signum:Dat.Pl	signīs	īs	īs
silentium:Nom.Sg	silentium	um	um
silentium:Abl.Pl	silentiīs	īs	īs
silentium:Dat.Sg	silentiō	ō	ō
silentium:Acc.Pl	silentia	a	a
silentium:Gen.Sg	silentiī	ī	ī
silentium:Gen.Pl	silentiōrum	ōrum	ēs
silentium:Abl.Sg	silentiō	ō	ō
silentium:Nom.Pl	silentia	a	a
silentium:Acc.Sg	silentium	um	um
silentium:Dat.Pl	silentiīs	īs	īs
silva:Nom.Sg	silva	a	a
silva:Abl.Pl	silvīs	īs	īs
silva:Dat.Sg	silvae	ae	a
silva:Acc.Pl	silvās	ās	ās
silva:Gen.Sg	silvae	ae	a
silva:Gen.Pl	silvārum	ārum	am
silva:Abl.Sg	silvā	ā	ā
silva:Nom.Pl	silvae	ae	a
silva:Acc.Sg	silvam	am	am
silva:Dat.Pl	silvīs	īs	īs
simulacrum:Nom.Sg	simulācrum	um	um
simulacrum:Abl.Pl	simulācrīs	īs	īs
simulacrum:Dat.Sg	simulācrō	ō	ē
simulacrum:Acc.Pl	simulācra	a	a
simulacrum:Gen.Sg	simulācrī	ī	ī
simulacrum:Gen.Pl	simulācrōrum	ōrum	ēs
simulacrum:Abl.Sg	simulācrō	ō	em
simulacrum:Nom.Pl	simulācra	a	a
simulacrum:Acc.Sg	simulācrum	um	um
simulacrum:Dat.Pl	simulācrīs	īs	īs
sinus:Nom.Sg	sinus	us	us
sinus:Abl.Pl	sinibus	ibus	ibus
sinus:Dat.Sg	sinuī	uī	um
sinus:Acc.Pl	sinūs	ūs	us
sinus:Gen.Sg	sinūs	ūs	ūs
sinus:Gen.Pl	sinuum	uum	ēs
sinus:Abl.Sg	sinū	ū	ū
sinus:Nom.Pl	sinūs	ūs	us
sinus:Acc.Sg	sinum	um	um
sinus:Dat.Pl	sinibus	ibus	ibus
sitis:Nom.Sg	sitis	is	ibus
sitis:Abl.Pl	N/AN/A	N/A	N/A
sitis:Dat.Sg	sitī	ī	ōs
sitis:Acc.Pl	N/AN/A	N/A	N/A
sitis:Gen.Sg	sitis	is	ōs
sitis:Gen.Pl	N/AN/A	N/A	N/A
sitis:Abl.Sg	site	e	e
sitis:Nom.Pl	N/AN/A	N/A	N/A
sitis:Acc.Sg	sitem	em	ēs
sitis:Dat.Pl	N/AN/A	N/A	N/A
sol:Nom.Sg	sōl	NULL	NULL
sol:Abl.Pl	sōlibus	ibus	ibus
sol:Dat.Sg	sōlī	ī	ī
sol:Acc.Pl	sōlēs	ēs	ēs
sol:Gen.Sg	sōlis	is	is
sol:Gen.Pl	sōlum	um	um
sol:Abl.Sg	sōle	e	e
sol:Nom.Pl	sōlēs	ēs	ēs
sol:Acc.Sg	sōlem	em	em
sol:Dat.Pl	sōlibus	ibus	ibus
solum:Nom.Sg	solum	um	um
solum:Abl.Pl	solīs	īs	īs
solum:Dat.Sg	solō	ō	ō
solum:Acc.Pl	sola	a	a
solum:Gen.Sg	solī	ī	ī
solum:Gen.Pl	solōrum	ōrum	ēs
solum:Abl.Sg	solō	ō	ō
solum:Nom.Pl	sola	a	a
solum:Acc.Sg	solum	um	um
solum:Dat.Pl	solīs	īs	īs
somnus:Nom.Sg	somnus	us	us
somnus:Abl.Pl	somnīs	īs	īs
somnus:Dat.Sg	somnō	ō	ō
somnus:Acc.Pl	somnōs	ōs	ūs
somnus:Gen.Sg	somnī	ī	ī
somnus:Gen.Pl	somnōrum	ōrum	ēs
somnus:Abl.Sg	somnō	ō	ō
somnus:Nom.Pl	somnī	ī	ī
somnus:Acc.Sg	somnum	um	um
somnus:Dat.Pl	somnīs	īs	īs
sonitus:Nom.Sg	sonitus	us	us
sonitus:Abl.Pl	sonitibus	ibus	ibus
sonitus:Dat.Sg	sonituī	uī	um
sonitus:Acc.Pl	sonitūs	ūs	us
sonitus:Gen.Sg	sonitūs	ūs	ūs
sonitus:Gen.Pl	sonituum	uum	ēs
sonitus:Abl.Sg	sonitū	ū	ū
sonitus:Nom.Pl	sonitūs	ūs	us
sonitus:Acc.Sg	sonitum	um	um
sonitus:Dat.Pl	sonitibus	ibus	ibus
sonus:Nom.Sg	sonus	us	us
sonus:Abl.Pl	sonīs	īs	īs
sonus:Dat.Sg	sonō	ō	ō
sonus:Acc.Pl	sonōs	ōs	ōs
sonus:Gen.Sg	sonī	ī	ī
sonus:Gen.Pl	sonōrum	ōrum	ēs
sonus:Abl.Sg	sonō	ō	ō
sonus:Nom.Pl	sonī	ī	ī
sonus:Acc.Sg	sonum	um	um
sonus:Dat.Pl	sonīs	īs	īs
soror:Nom.Sg	soror	NULL	NULL
soror:Abl.Pl	sorōribus	ibus	ibus
soror:Dat.Sg	sorōrī	ī	ī
soror:Acc.Pl	sorōrēs	ēs	ēs
soror:Gen.Sg	sorōris	is	is
soror:Gen.Pl	sorōrum	um	um
soror:Abl.Sg	sorōre	e	e
soror:Nom.Pl	sorōrēs	ēs	ēs
soror:Acc.Sg	sorōrem	em	em
soror:Dat.Pl	sorōribus	ibus	ibus
sors:Nom.Sg	sors	NULL	NULL
sors:Abl.Pl	sortibus	ibus	ibus
sors:Dat.Sg	sortī	ī	ī
sors:Acc.Pl	sortēs	ēs	ēs
sors:Gen.Sg	sortis	is	is
sors:Gen.Pl	sortium	ium	ium
sors:Abl.Sg	sorte	e	e
sors:Nom.Pl	sortēs	ēs	ēs
sors:Acc.Sg	sortem	em	em
sors:Dat.Pl	sortibus	ibus	ibus
spatium:Nom.Sg	spatium	um	um
spatium:Abl.Pl	spatiīs	īs	īs
spatium:Dat.Sg	spatiō	ō	ō
spatium:Acc.Pl	spatia	a	a
spatium:Gen.Sg	spatiī	ī	ī
spatium:Gen.Pl	spatiōrum	ōrum	ēs
spatium:Abl.Sg	spatiō	ō	ō
spatium:Nom.Pl	spatia	a	a
spatium:Acc.Sg	spatium	um	um
spatium:Dat.Pl	spatiīs	īs	īs
species:Nom.Sg	speciēs	ēs	ēs
species:Abl.Pl	speciēbus	ēbus	ēs
species:Dat.Sg	speciēī	ēī	ēs
species:Acc.Pl	speciēs	ēs	ēs
species:Gen.Sg	speciēī	ēī	ēs
species:Gen.Pl	speciērum	ērum	ēs
species:Abl.Sg	speciē	ē	em
species:Nom.Pl	speciēs	ēs	ēs
species:Acc.Sg	speciem	em	ēs
species:Dat.Pl	speciēbus	ēbus	ēs
specus:Nom.Sg	specus	us	us
specus:Abl.Pl	specubus	ubus	ibus
specus:Dat.Sg	specuī	uī	ibus
specus:Acc.Pl	specūs	ūs	us
specus:Gen.Sg	specūs	ūs	ūs
specus:Gen.Pl	specuum	uum	ēī
specus:Abl.Sg	specū	ū	ū
specus:Nom.Pl	specūs	ūs	us
specus:Acc.Sg	specum	um	um
specus:Dat.Pl	specubus	ubus	ibus
spes:Nom.Sg	spēs	ēs	ēs
spes:Abl.Pl	spēbus	ēbus	ēs
spes:Dat.Sg	speī	eī	a
spes:Acc.Pl	spēs	ēs	ēs
spes:Gen.Sg	speī	eī	a
spes:Gen.Pl	spērum	ērum	ēs
spes:Abl.Sg	spē	ē	ō
spes:Nom.Pl	spēs	ēs	ēs
spes:Acc.Sg	spem	em	ēs
spes:Dat.Pl	spēbus	ēbus	ēs
spiritus:Nom.Sg	spīritus	us	us
spiritus:Abl.Pl	spīritibus	ibus	ibus
spiritus:Dat.Sg	spīrituī	uī	uī
spiritus:Acc.Pl	spīritūs	ūs	us
spiritus:Gen.Sg	spīritūs	ūs	ūs
spiritus:Gen.Pl	spīrituum	uum	ēs
spiritus:Abl.Sg	spīritū	ū	ū
spiritus:Nom.Pl	spīritūs	ūs	us
spiritus:Acc.Sg	spīritum	um	um
spiritus:Dat.Pl	spīritibus	ibus	ibus
spolium:Nom.Sg	spolium	um	um
spolium:Abl.Pl	spoliīs	īs	īs
spolium:Dat.Sg	spoliō	ō	ō
spolium:Acc.Pl	spolia	a	a
spolium:Gen.Sg	spoliī	ī	ī
spolium:Gen.Pl	spoliōrum	ōrum	ēs
spolium:Abl.Sg	spoliō	ō	em
spolium:Nom.Pl	spolia	a	a
spolium:Acc.Sg	spolium	um	um
spolium:Dat.Pl	spoliīs	īs	īs
spons:Nom.Sg	spōns	NULL	ēs
spons:Abl.Pl	N/AN/A	N/A	N/A
spons:Dat.Sg	spontī	ī	ēs
spons:Acc.Pl	N/AN/A	N/A	N/A
spons:Gen.Sg	spontis	is	uum
spons:Gen.Pl	N/AN/A	N/A	N/A
spons:Abl.Sg	sponte	e	em
spons:Nom.Pl	N/AN/A	N/A	N/A
spons:Acc.Sg	spontem	em	ēs
spons:Dat.Pl	N/AN/A	N/A	N/A
status:Nom.Sg	status	us	us
status:Abl.Pl	statibus	ibus	ibus
status:Dat.Sg	statuī	uī	uī
status:Acc.Pl	statūs	ūs	us
status:Gen.Sg	statūs	ūs	ūs
status:Gen.Pl	statuum	uum	ēs
status:Abl.Sg	statū	ū	ī
status:Nom.Pl	statūs	ūs	us
status:Acc.Sg	statum	um	um
status:Dat.Pl	statibus	ibus	ibus
stella:Nom.Sg	stēlla	a	a
stella:Abl.Pl	stēllīs	īs	īs
stella:Dat.Sg	stēllae	ae	a
stella:Acc.Pl	stēllās	ās	ās
stella:Gen.Sg	stēllae	ae	a
stella:Gen.Pl	stēllārum	ārum	ā
stella:Abl.Sg	stēllā	ā	ā
stella:Nom.Pl	stēllae	ae	a
stella:Acc.Sg	stēllam	am	am
stella:Dat.Pl	stēllīs	īs	īs
stirps:Nom.Sg	stirps	NULL	NULL
stirps:Abl.Pl	stirpibus	ibus	ibus
stirps:Dat.Sg	stirpī	ī	ī
stirps:Acc.Pl	stirpēs	ēs	ēs
stirps:Gen.Sg	stirpis	is	is
stirps:Gen.Pl	stirpium	ium	a
stirps:Abl.Sg	stirpe	e	e
stirps:Nom.Pl	stirpēs	ēs	ēbus
stirps:Acc.Sg	stirpem	em	em
stirps:Dat.Pl	stirpibus	ibus	ibus
strepitus:Nom.Sg	strepitus	us	us
strepitus:Abl.Pl	strepitibus	ibus	ibus
strepitus:Dat.Sg	strepituī	uī	ōs
strepitus:Acc.Pl	strepitūs	ūs	us
strepitus:Gen.Sg	strepitūs	ūs	ūs
strepitus:Gen.Pl	strepituum	uum	ibus
strepitus:Abl.Sg	strepitū	ū	ī
strepitus:Nom.Pl	strepitūs	ūs	us
strepitus:Acc.Sg	strepitum	um	um
strepitus:Dat.Pl	strepitibus	ibus	ibus
studium:Nom.Sg	studium	um	um
studium:Abl.Pl	studiīs	īs	īs
studium:Dat.Sg	studiō	ō	ō
studium:Acc.Pl	studia	a	a
studium:Gen.Sg	studiī	ī	ī
studium:Gen.Pl	studiōrum	ōrum	ēs
studium:Abl.Sg	studiō	ō	ō
studium:Nom.Pl	studia	a	a
studium:Acc.Sg	studium	um	um
studium:Dat.Pl	studiīs	īs	īs
summa:Nom.Sg	summa	a	a
summa:Abl.Pl	summīs	īs	īs
summa:Dat.Sg	summae	ae	ae
summa:Acc.Pl	summās	ās	ās
summa:Gen.Sg	summae	ae	ae
summa:Gen.Pl	summārum	ārum	ās
summa:Abl.Sg	summā	ā	ās
summa:Nom.Pl	summae	ae	a
summa:Acc.Sg	summam	am	am
summa:Dat.Pl	summīs	īs	īs
supplicium:Nom.Sg	supplicium	um	um
supplicium:Abl.Pl	suppliciīs	īs	īs
supplicium:Dat.Sg	suppliciō	ō	e
supplicium:Acc.Pl	supplicia	a	a
supplicium:Gen.Sg	suppliciī	ī	ī
supplicium:Gen.Pl	suppliciōrum	ōrum	ēs
supplicium:Abl.Sg	suppliciō	ō	ō
supplicium:Nom.Pl	supplicia	a	a
supplicium:Acc.Sg	supplicium	um	um
supplicium:Dat.Pl	suppliciīs	īs	īs
tabula:Nom.Sg	tabula	a	a
tabula:Abl.Pl	tabulīs	īs	īs
tabula:Dat.Sg	tabulae	ae	a
tabula:Acc.Pl	tabulās	ās	ās
tabula:Gen.Sg	tabulae	ae	a
tabula:Gen.Pl	tabulārum	ārum	ā
tabula:Abl.Sg	tabulā	ā	ā
tabula:Nom.Pl	tabulae	ae	a
tabula:Acc.Sg	tabulam	am	am
tabula:Dat.Pl	tabulīs	īs	īs
taurus:Nom.Sg	taurus	us	us
taurus:Abl.Pl	taurīs	īs	īs
taurus:Dat.Sg	taurō	ō	ō
taurus:Acc.Pl	taurōs	ōs	ōs
taurus:Gen.Sg	taurī	ī	ī
taurus:Gen.Pl	taurōrum	ōrum	ēs
taurus:Abl.Sg	taurō	ō	ō
taurus:Nom.Pl	taurī	ī	ī
taurus:Acc.Sg	taurum	um	um
taurus:Dat.Pl	taurīs	īs	īs
tectum:Nom.Sg	tēctum	um	um
tectum:Abl.Pl	tēctīs	īs	īs
tectum:Dat.Sg	tēctō	ō	ō
tectum:Acc.Pl	tēcta	a	a
tectum:Gen.Sg	tēctī	ī	ī
tectum:Gen.Pl	tēctōrum	ōrum	ēs
tectum:Abl.Sg	tēctō	ō	ō
tectum:Nom.Pl	tēcta	a	a
tectum:Acc.Sg	tēctum	um	um
tectum:Dat.Pl	tēctīs	īs	īs
telum:Nom.Sg	tēlum	um	um
telum:Abl.Pl	tēlīs	īs	īs
telum:Dat.Sg	tēlō	ō	ō
telum:Acc.Pl	tēla	a	a
telum:Gen.Sg	tēlī	ī	ī
telum:Gen.Pl	tēlōrum	ōrum	ēs
telum:Abl.Sg	tēlō	ō	ō
telum:Nom.Pl	tēla	a	a
telum:Acc.Sg	tēlum	um	um
telum:Dat.Pl	tēlīs	īs	īs
tempestas:Nom.Sg	tempestās	NULL	NULL
tempestas:Abl.Pl	tempestātibus	ibus	ibus
tempestas:Dat.Sg	tempestātī	ī	ī
tempestas:Acc.Pl	tempestātēs	ēs	ēs
tempestas:Gen.Sg	tempestātis	is	is
tempestas:Gen.Pl	tempestātum	um	um
tempestas:Abl.Sg	tempestāte	e	e
tempestas:Nom.Pl	tempestātēs	ēs	ēs
tempestas:Acc.Sg	tempestātem	em	em
tempestas:Dat.Pl	tempestātibus	ibus	ibus
templum:Nom.Sg	templum	um	um
templum:Abl.Pl	templīs	īs	īs
templum:Dat.Sg	templō	ō	ō
templum:Acc.Pl	templa	a	a
templum:Gen.Sg	templī	ī	ī
templum:Gen.Pl	templōrum	ōrum	ōrum
templum:Abl.Sg	templō	ō	ō
templum:Nom.Pl	templa	a	a
templum:Acc.Sg	templum	um	um
templum:Dat.Pl	templīs	īs	īs
tempus:Nom.Sg	tempus	NULL	NULL
tempus:Abl.Pl	temporibus	ibus	ibus
tempus:Dat.Sg	temporī	ī	ī
tempus:Acc.Pl	tempora	a	a
tempus:Gen.Sg	temporis	is	is
tempus:Gen.Pl	temporum	um	um
tempus:Abl.Sg	tempore	e	e
tempus:Nom.Pl	tempora	a	a
tempus:Acc.Sg	tempus	NULL	NULL
tempus:Dat.Pl	temporibus	ibus	ibus
tenebrae:Nom.Sg	N/AN/A	N/A	N/A
tenebrae:Abl.Pl	tenebrīs	īs	īs
tenebrae:Dat.Sg	N/AN/A	N/A	a
tenebrae:Acc.Pl	tenebrās	ās	ās
tenebrae:Gen.Sg	N/AN/A	N/A	N/A
tenebrae:Gen.Pl	tenebrārum	ārum	ās
tenebrae:Abl.Sg	N/AN/A	N/A	N/A
tenebrae:Nom.Pl	tenebrae	ae	a
tenebrae:Acc.Sg	N/AN/A	N/A	N/A
tenebrae:Dat.Pl	tenebrīs	īs	īs
tergum:Nom.Sg	tergum	um	um
tergum:Abl.Pl	tergīs	īs	īs
tergum:Dat.Sg	tergō	ō	ō
tergum:Acc.Pl	terga	a	a
tergum:Gen.Sg	tergī	ī	ī
tergum:Gen.Pl	tergōrum	ōrum	ēs
tergum:Abl.Sg	tergō	ō	ō
tergum:Nom.Pl	terga	a	a
tergum:Acc.Sg	tergum	um	um
tergum:Dat.Pl	tergīs	īs	īs
terra:Nom.Sg	terra	a	a
terra:Abl.Pl	terrīs	īs	īs
terra:Dat.Sg	terrae	ae	ae
terra:Acc.Pl	terrās	ās	ās
terra:Gen.Sg	terrae	ae	ae
terra:Gen.Pl	terrārum	ārum	ā
terra:Abl.Sg	terrā	ā	ā
terra:Nom.Pl	terrae	ae	a
terra:Acc.Sg	terram	am	am
terra:Dat.Pl	terrīs	īs	īs
terror:Nom.Sg	terror	NULL	NULL
terror:Abl.Pl	terrōribus	ibus	ibus
terror:Dat.Sg	terrōrī	ī	ī
terror:Acc.Pl	terrōrēs	ēs	ēs
terror:Gen.Sg	terrōris	is	is
terror:Gen.Pl	terrōrum	um	um
terror:Abl.Sg	terrōre	e	e
terror:Nom.Pl	terrōrēs	ēs	ēs
terror:Acc.Sg	terrōrem	em	em
terror:Dat.Pl	terrōribus	ibus	ibus
testis:Nom.Sg	testis	is	īs
testis:Abl.Pl	testibus	ibus	ibus
testis:Dat.Sg	testī	ī	ī
testis:Acc.Pl	testēs	ēs	ēs
testis:Gen.Sg	testis	is	is
testis:Gen.Pl	testium	ium	ēbus
testis:Abl.Sg	teste	e	e
testis:Nom.Pl	testēs	ēs	ēs
testis:Acc.Sg	testem	em	em
testis:Dat.Pl	testibus	ibus	ibus
theatrum:Nom.Sg	theātrum	um	um
theatrum:Abl.Pl	theātrīs	īs	īs
theatrum:Dat.Sg	theātrō	ō	ō
theatrum:Acc.Pl	theātra	a	a
theatrum:Gen.Sg	theātrī	ī	ī
theatrum:Gen.Pl	theātrōrum	ōrum	ēs
theatrum:Abl.Sg	theātrō	ō	em
theatrum:Nom.Pl	theātra	a	a
theatrum:Acc.Sg	theātrum	um	um
theatrum:Dat.Pl	theātrīs	īs	īs
timor:Nom.Sg	timor	NULL	NULL
timor:Abl.Pl	timōribus	ibus	ibus
timor:Dat.Sg	timōrī	ī	ī
timor:Acc.Pl	timōrēs	ēs	ēs
timor:Gen.Sg	timōris	is	is
timor:Gen.Pl	timōrum	um	um
timor:Abl.Sg	timōre	e	e
timor:Nom.Pl	timōrēs	ēs	ēs
timor:Acc.Sg	timōrem	em	em
timor:Dat.Pl	timōribus	ibus	ibus
torus:Nom.Sg	torus	us	us
torus:Abl.Pl	torīs	īs	īs
torus:Dat.Sg	torō	ō	ō
torus:Acc.Pl	torōs	ōs	ōs
torus:Gen.Sg	torī	ī	ī
torus:Gen.Pl	torōrum	ōrum	ēs
torus:Abl.Sg	torō	ō	ō
torus:Nom.Pl	torī	ī	ī
torus:Acc.Sg	torum	um	um
torus:Dat.Pl	torīs	īs	īs
trabs:Nom.Sg	trabs	NULL	NULL
trabs:Abl.Pl	trabibus	ibus	ibus
trabs:Dat.Sg	trabī	ī	ī
trabs:Acc.Pl	trabēs	ēs	ēs
trabs:Gen.Sg	trabis	is	is
trabs:Gen.Pl	trabum	um	ēs
trabs:Abl.Sg	trabe	e	e
trabs:Nom.Pl	trabēs	ēs	ēs
trabs:Acc.Sg	trabem	em	em
trabs:Dat.Pl	trabibus	ibus	ibus
triumphus:Nom.Sg	triumphus	us	us
triumphus:Abl.Pl	triumphīs	īs	īs
triumphus:Dat.Sg	triumphō	ō	e
triumphus:Acc.Pl	triumphōs	ōs	ēs
triumphus:Gen.Sg	triumphī	ī	ī
triumphus:Gen.Pl	triumphōrum	ōrum	ēs
triumphus:Abl.Sg	triumphō	ō	ō
triumphus:Nom.Pl	triumphī	ī	ī
triumphus:Acc.Sg	triumphum	um	um
triumphus:Dat.Pl	triumphīs	īs	īs
tumultus:Nom.Sg	tumultus	us	us
tumultus:Abl.Pl	tumultibus	ibus	ibus
tumultus:Dat.Sg	tumultuī	uī	um
tumultus:Acc.Pl	tumultūs	ūs	us
tumultus:Gen.Sg	tumultūs	ūs	ūs
tumultus:Gen.Pl	tumultuum	uum	ēs
tumultus:Abl.Sg	tumultū	ū	ū
tumultus:Nom.Pl	tumultūs	ūs	us
tumultus:Acc.Sg	tumultum	um	um
tumultus:Dat.Pl	tumultibus	ibus	ibus
tumulus:Nom.Sg	tumulus	us	us
tumulus:Abl.Pl	tumulīs	īs	īs
tumulus:Dat.Sg	tumulō	ō	ō
tumulus:Acc.Pl	tumulōs	ōs	ūs
tumulus:Gen.Sg	tumulī	ī	ī
tumulus:Gen.Pl	tumulōrum	ōrum	ēs
tumulus:Abl.Sg	tumulō	ō	ō
tumulus:Nom.Pl	tumulī	ī	ī
tumulus:Acc.Sg	tumulum	um	um
tumulus:Dat.Pl	tumulīs	īs	īs
turba:Nom.Sg	turba	a	a
turba:Abl.Pl	turbīs	īs	īs
turba:Dat.Sg	turbae	ae	ae
turba:Acc.Pl	turbās	ās	ās
turba:Gen.Sg	turbae	ae	a
turba:Gen.Pl	turbārum	ārum	ās
turba:Abl.Sg	turbā	ā	ā
turba:Nom.Pl	turbae	ae	a
turba:Acc.Sg	turbam	am	am
turba:Dat.Pl	turbīs	īs	īs
turris:Nom.Sg	turris	is	īs
turris:Abl.Pl	turribus	ibus	ibus
turris:Dat.Sg	turrī	ī	ī
turris:Acc.Pl	turrēs	ēs	ēs
turris:Gen.Sg	turris	is	is
turris:Gen.Pl	turrium	ium	ium
turris:Abl.Sg	turre	e	e
turris:Nom.Pl	turrēs	ēs	ēs
turris:Acc.Sg	turrem	em	em
turris:Dat.Pl	turribus	ibus	ibus
tympanum:Nom.Sg	tympanum	um	um
tympanum:Abl.Pl	tympanīs	īs	a
tympanum:Dat.Sg	tympanō	ō	ō
tympanum:Acc.Pl	tympana	a	a
tympanum:Gen.Sg	tympanī	ī	ī
tympanum:Gen.Pl	tympanōrum	ōrum	ēs
tympanum:Abl.Sg	tympanō	ō	ō
tympanum:Nom.Pl	tympana	a	a
tympanum:Acc.Sg	tympanum	um	um
tympanum:Dat.Pl	tympanīs	īs	a
tyrannus:Nom.Sg	tyrannus	us	us
tyrannus:Abl.Pl	tyrannīs	īs	a
tyrannus:Dat.Sg	tyrannō	ō	ō
tyrannus:Acc.Pl	tyrannōs	ōs	ē
tyrannus:Gen.Sg	tyrannī	ī	ī
tyrannus:Gen.Pl	tyrannōrum	ōrum	ēs
tyrannus:Abl.Sg	tyrannō	ō	ō
tyrannus:Nom.Pl	tyrannī	ī	ī
tyrannus:Acc.Sg	tyrannum	um	um
tyrannus:Dat.Pl	tyrannīs	īs	a
umbra:Nom.Sg	umbra	a	a
umbra:Abl.Pl	umbrīs	īs	īs
umbra:Dat.Sg	umbrae	ae	ae
umbra:Acc.Pl	umbrās	ās	ās
umbra:Gen.Sg	umbrae	ae	ae
umbra:Gen.Pl	umbrārum	ārum	ā
umbra:Abl.Sg	umbrā	ā	ā
umbra:Nom.Pl	umbrae	ae	a
umbra:Acc.Sg	umbram	am	am
umbra:Dat.Pl	umbrīs	īs	īs
unda:Nom.Sg	unda	a	a
unda:Abl.Pl	undīs	īs	īs
unda:Dat.Sg	undae	ae	ae
unda:Acc.Pl	undās	ās	ās
unda:Gen.Sg	undae	ae	a
unda:Gen.Pl	undārum	ārum	ā
unda:Abl.Sg	undā	ā	ā
unda:Nom.Pl	undae	ae	a
unda:Acc.Sg	undam	am	am
unda:Dat.Pl	undīs	īs	īs
urbs:Nom.Sg	urbs	NULL	NULL
urbs:Abl.Pl	urbibus	ibus	ibus
urbs:Dat.Sg	urbī	ī	ī
urbs:Acc.Pl	urbēs	ēs	ēs
urbs:Gen.Sg	urbis	is	is
urbs:Gen.Pl	urbium	ium	ium
urbs:Abl.Sg	urbe	e	e
urbs:Nom.Pl	urbēs	ēs	ēs
urbs:Acc.Sg	urbem	em	em
urbs:Dat.Pl	urbibus	ibus	ibus
uxor:Nom.Sg	uxor	NULL	NULL
uxor:Abl.Pl	uxōribus	ibus	ibus
uxor:Dat.Sg	uxōrī	ī	ī
uxor:Acc.Pl	uxōrēs	ēs	ēs
uxor:Gen.Sg	uxōris	is	is
uxor:Gen.Pl	uxōrum	um	um
uxor:Abl.Sg	uxōre	e	e
uxor:Nom.Pl	uxōrēs	ēs	ēs
uxor:Acc.Sg	uxōrem	em	em
uxor:Dat.Pl	uxōribus	ibus	ibus
vadum:Nom.Sg	vadum	um	um
vadum:Abl.Pl	vadīs	īs	īs
vadum:Dat.Sg	vadō	ō	ō
vadum:Acc.Pl	vada	a	a
vadum:Gen.Sg	vadī	ī	ī
vadum:Gen.Pl	vadōrum	ōrum	ēs
vadum:Abl.Sg	vadō	ō	ō
vadum:Nom.Pl	vada	a	a
vadum:Acc.Sg	vadum	um	um
vadum:Dat.Pl	vadīs	īs	īs
vallis:Nom.Sg	vallis	is	īs
vallis:Abl.Pl	vallibus	ibus	ibus
vallis:Dat.Sg	vallī	ī	ī
vallis:Acc.Pl	vallēs	ēs	ēs
vallis:Gen.Sg	vallis	is	is
vallis:Gen.Pl	vallium	ium	ium
vallis:Abl.Sg	valle	e	e
vallis:Nom.Pl	vallēs	ēs	ēs
vallis:Acc.Sg	vallem	em	ēs
vallis:Dat.Pl	vallibus	ibus	ibus
vates:Nom.Sg	vātēs	ēs	ēs
vates:Abl.Pl	vātibus	ibus	ibus
vates:Dat.Sg	vātī	ī	ī
vates:Acc.Pl	vātēs	ēs	ēs
vates:Gen.Sg	vātis	is	is
vates:Gen.Pl	vātium	ium	a
vates:Abl.Sg	vāte	e	e
vates:Nom.Pl	vātēs	ēs	ēs
vates:Acc.Sg	vātem	em	em
vates:Dat.Pl	vātibus	ibus	ibus
velum:Nom.Sg	vēlum	um	um
velum:Abl.Pl	vēlīs	īs	īs
velum:Dat.Sg	vēlō	ō	ō
velum:Acc.Pl	vēla	a	a
velum:Gen.Sg	vēlī	ī	ī
velum:Gen.Pl	vēlōrum	ōrum	ēs
velum:Abl.Sg	vēlō	ō	ō
velum:Nom.Pl	vēla	a	a
velum:Acc.Sg	vēlum	um	um
velum:Dat.Pl	vēlīs	īs	īs
vena:Nom.Sg	vēna	a	a
vena:Abl.Pl	vēnīs	īs	īs
vena:Dat.Sg	vēnae	ae	ae
vena:Acc.Pl	vēnās	ās	ās
vena:Gen.Sg	vēnae	ae	a
vena:Gen.Pl	vēnārum	ārum	ā
vena:Abl.Sg	vēnā	ā	ā
vena:Nom.Pl	vēnae	ae	a
vena:Acc.Sg	vēnam	am	am
vena:Dat.Pl	vēnīs	īs	īs
venenum:Nom.Sg	venēnum	um	um
venenum:Abl.Pl	venēnīs	īs	īs
venenum:Dat.Sg	venēnō	ō	ō
venenum:Acc.Pl	venēna	a	a
venenum:Gen.Sg	venēnī	ī	ī
venenum:Gen.Pl	venēnōrum	ōrum	ēs
venenum:Abl.Sg	venēnō	ō	em
venenum:Nom.Pl	venēna	a	a
venenum:Acc.Sg	venēnum	um	um
venenum:Dat.Pl	venēnīs	īs	īs
venia:Nom.Sg	venia	a	a
venia:Abl.Pl	veniīs	īs	īs
venia:Dat.Sg	veniae	ae	a
venia:Acc.Pl	veniās	ās	ās
venia:Gen.Sg	veniae	ae	a
venia:Gen.Pl	veniārum	ārum	ās
venia:Abl.Sg	veniā	ā	ās
venia:Nom.Pl	veniae	ae	a
venia:Acc.Sg	veniam	am	am
venia:Dat.Pl	veniīs	īs	īs
venter:Nom.Sg	venter	NULL	em
venter:Abl.Pl	ventribus	ibus	ibus
venter:Dat.Sg	ventrī	ī	ī
venter:Acc.Pl	ventrēs	ēs	ēs
venter:Gen.Sg	ventris	is	is
venter:Gen.Pl	ventrium	ium	ēbus
venter:Abl.Sg	ventre	e	e
venter:Nom.Pl	ventrēs	ēs	ēs
venter:Acc.Sg	ventrem	em	em
venter:Dat.Pl	ventribus	ibus	ibus
ventus:Nom.Sg	ventus	us	us
ventus:Abl.Pl	ventīs	īs	īs
ventus:Dat.Sg	ventō	ō	ō
ventus:Acc.Pl	ventōs	ōs	ōs
ventus:Gen.Sg	ventī	ī	ī
ventus:Gen.Pl	ventōrum	ōrum	ēs
ventus:Abl.Sg	ventō	ō	ō
ventus:Nom.Pl	ventī	ī	ī
ventus:Acc.Sg	ventum	um	um
ventus:Dat.Pl	ventīs	īs	īs
ver:Nom.Sg	vēr	NULL	NULL
ver:Abl.Pl	vēribus	ibus	ibus
ver:Dat.Sg	vērī	ī	ī
ver:Acc.Pl	vēra	a	a
ver:Gen.Sg	vēris	is	is
ver:Gen.Pl	vērum	um	um
ver:Abl.Sg	vēre	e	e
ver:Nom.Pl	vēra	a	a
ver:Acc.Sg	vēr	NULL	NULL
ver:Dat.Pl	vēribus	ibus	ibus
verber:Nom.Sg	verber	NULL	NULL
verber:Abl.Pl	verberibus	ibus	ibus
verber:Dat.Sg	verberī	ī	ī
verber:Acc.Pl	verbera	a	a
verber:Gen.Sg	verberis	is	is
verber:Gen.Pl	verberum	um	um
verber:Abl.Sg	verbere	e	e
verber:Nom.Pl	verbera	a	a
verber:Acc.Sg	verber	NULL	NULL
verber:Dat.Pl	verberibus	ibus	ibus
verbum:Nom.Sg	verbum	um	um
verbum:Abl.Pl	verbīs	īs	īs
verbum:Dat.Sg	verbō	ō	ō
verbum:Acc.Pl	verba	a	a
verbum:Gen.Sg	verbī	ī	ī
verbum:Gen.Pl	verbōrum	ōrum	ēs
verbum:Abl.Sg	verbō	ō	ō
verbum:Nom.Pl	verba	a	a
verbum:Acc.Sg	verbum	um	um
verbum:Dat.Pl	verbīs	īs	īs
versus:Nom.Sg	versus	us	us
versus:Abl.Pl	versibus	ibus	ibus
versus:Dat.Sg	versuī	uī	um
versus:Acc.Pl	versūs	ūs	us
versus:Gen.Sg	versūs	ūs	ūs
versus:Gen.Pl	versuum	uum	ēs
versus:Abl.Sg	versū	ū	ū
versus:Nom.Pl	versūs	ūs	us
versus:Acc.Sg	versum	um	um
versus:Dat.Pl	versibus	ibus	ibus
vertex:Nom.Sg	vertex	NULL	NULL
vertex:Abl.Pl	verticibus	ibus	ibus
vertex:Dat.Sg	verticī	ī	ī
vertex:Acc.Pl	verticēs	ēs	ēs
vertex:Gen.Sg	verticis	is	is
vertex:Gen.Pl	verticum	um	um
vertex:Abl.Sg	vertice	e	e
vertex:Nom.Pl	verticēs	ēs	ēs
vertex:Acc.Sg	verticem	em	em
vertex:Dat.Pl	verticibus	ibus	ibus
verum:Nom.Sg	vērum	um	um
verum:Abl.Pl	vērīs	īs	īs
verum:Dat.Sg	vērō	ō	ō
verum:Acc.Pl	vēra	a	a
verum:Gen.Sg	vērī	ī	ī
verum:Gen.Pl	vērōrum	ōrum	ēs
verum:Abl.Sg	vērō	ō	ō
verum:Nom.Pl	vēra	a	a
verum:Acc.Sg	vērum	um	um
verum:Dat.Pl	vērīs	īs	īs
vestigium:Nom.Sg	vestīgium	um	um
vestigium:Abl.Pl	vestīgiīs	īs	ēs
vestigium:Dat.Sg	vestīgiō	ō	em
vestigium:Acc.Pl	vestīgia	a	a
vestigium:Gen.Sg	vestīgiī	ī	ī
vestigium:Gen.Pl	vestīgiōrum	ōrum	ēs
vestigium:Abl.Sg	vestīgiō	ō	em
vestigium:Nom.Pl	vestīgia	a	a
vestigium:Acc.Sg	vestīgium	um	um
vestigium:Dat.Pl	vestīgiīs	īs	īs
vestis:Nom.Sg	vestis	is	īs
vestis:Abl.Pl	vestibus	ibus	ibus
vestis:Dat.Sg	vestī	ī	ī
vestis:Acc.Pl	vestēs	ēs	ēs
vestis:Gen.Sg	vestis	is	is
vestis:Gen.Pl	vestum	um	um
vestis:Abl.Sg	veste	e	e
vestis:Nom.Pl	vestēs	ēs	ēs
vestis:Acc.Sg	vestem	em	em
vestis:Dat.Pl	vestibus	ibus	ibus
via:Nom.Sg	via	a	a
via:Abl.Pl	viīs	īs	īs
via:Dat.Sg	viae	ae	ae
via:Acc.Pl	viās	ās	ās
via:Gen.Sg	viae	ae	a
via:Gen.Pl	viārum	ārum	ās
via:Abl.Sg	viā	ā	ās
via:Nom.Pl	viae	ae	a
via:Acc.Sg	viam	am	am
via:Dat.Pl	viīs	īs	īs
vicis:Nom.Sg	N/AN/A	N/A	N/A
vicis:Abl.Pl	vicibus	ibus	ibus
vicis:Dat.Sg	vicī	ī	ī
vicis:Acc.Pl	vicēs	ēs	ēs
vicis:Gen.Sg	vicis	is	is
vicis:Gen.Pl	vicum	um	ēs
vicis:Abl.Sg	vice	e	e
vicis:Nom.Pl	vicēs	ēs	ēs
vicis:Acc.Sg	vicem	em	em
vicis:Dat.Pl	vicibus	ibus	ibus
victor:Nom.Sg	victor	NULL	NULL
victor:Abl.Pl	victoribus	ibus	ibus
victor:Dat.Sg	victōrī	ī	ī
victor:Acc.Pl	victōrēs	ēs	ēs
victor:Gen.Sg	victōris	is	is
victor:Gen.Pl	victōrum	um	um
victor:Abl.Sg	victōre	e	e
victor:Nom.Pl	victōrēs	ēs	ēs
victor:Acc.Sg	victōrem	em	em
victor:Dat.Pl	victōribus	ibus	ibus
villa:Nom.Sg	vīlla	a	a
villa:Abl.Pl	vīllīs	īs	īs
villa:Dat.Sg	vīllae	ae	a
villa:Acc.Pl	vīllās	ās	ās
villa:Gen.Sg	vīllae	ae	a
villa:Gen.Pl	vīllārum	ārum	ās
villa:Abl.Sg	vīllā	ā	ā
villa:Nom.Pl	vīllae	ae	a
villa:Acc.Sg	vīllam	am	am
villa:Dat.Pl	vīllīs	īs	īs
vinculum:Nom.Sg	vinculum	um	um
vinculum:Abl.Pl	vinculīs	īs	īs
vinculum:Dat.Sg	vinculō	ō	ō
vinculum:Acc.Pl	vincula	a	a
vinculum:Gen.Sg	vinculī	ī	ī
vinculum:Gen.Pl	vinculōrum	ōrum	ēs
vinculum:Abl.Sg	vinculō	ō	em
vinculum:Nom.Pl	vincula	a	a
vinculum:Acc.Sg	vinculum	um	um
vinculum:Dat.Pl	vinculīs	īs	īs
vinum:Nom.Sg	vīnum	um	um
vinum:Abl.Pl	vīnīs	īs	īs
vinum:Dat.Sg	vīnō	ō	ō
vinum:Acc.Pl	vīna	a	a
vinum:Gen.Sg	vīnī	ī	ī
vinum:Gen.Pl	vīnōrum	ōrum	ēs
vinum:Abl.Sg	vīnō	ō	ō
vinum:Nom.Pl	vīna	a	a
vinum:Acc.Sg	vīnum	um	um
vinum:Dat.Pl	vīnīs	īs	īs
vir:Nom.Sg	vir	NULL	NULL
vir:Abl.Pl	virīs	īs	īs
vir:Dat.Sg	virō	ō	ō
vir:Acc.Pl	virōs	ōs	ōs
vir:Gen.Sg	virī	ī	ī
vir:Gen.Pl	virōrum	ōrum	ēs
vir:Abl.Sg	virō	ō	ō
vir:Nom.Pl	virī	ī	ī
vir:Acc.Sg	virum	um	um
vir:Dat.Pl	virīs	īs	īs
virgo:Nom.Sg	virgō	NULL	NULL
virgo:Abl.Pl	virginibus	ibus	ibus
virgo:Dat.Sg	virginī	ī	ī
virgo:Acc.Pl	virginēs	ēs	ēs
virgo:Gen.Sg	virginis	is	is
virgo:Gen.Pl	virginum	um	um
virgo:Abl.Sg	virgine	e	e
virgo:Nom.Pl	virginēs	ēs	ēs
virgo:Acc.Sg	virginem	em	em
virgo:Dat.Pl	virginibus	ibus	ibus
virtus:Nom.Sg	virtūs	NULL	NULL
virtus:Abl.Pl	virtūtibus	ibus	ibus
virtus:Dat.Sg	virtūtī	ī	ī
virtus:Acc.Pl	virtūtēs	ēs	ēs
virtus:Gen.Sg	virtūtis	is	is
virtus:Gen.Pl	virtūtum	um	ēs
virtus:Abl.Sg	virtūte	e	e
virtus:Nom.Pl	virtūtēs	ēs	ēs
virtus:Acc.Sg	virtūtem	em	em
virtus:Dat.Pl	virtūtibus	ibus	ibus
vis:Nom.Sg	vīs	NULL	NULL
vis:Abl.Pl	vīribus	ibus	ibus
vis:Dat.Sg	vī	NULL	NULL
vis:Acc.Pl	vīrēs	ēs	ēs
vis:Gen.Sg	vīs	NULL	NULL
vis:Gen.Pl	vīrium	ium	ium
vis:Abl.Sg	vī	NULL	NULL
vis:Nom.Pl	vīrēs	ēs	ēs
vis:Acc.Sg	vim	m	NULL
vis:Dat.Pl	vīribus	ibus	ibus
viscus:Nom.Sg	viscus	NULL	NULL
viscus:Abl.Pl	visceribus	ibus	ibus
viscus:Dat.Sg	viscerī	ī	ī
viscus:Acc.Pl	viscera	a	a
viscus:Gen.Sg	visceris	is	is
viscus:Gen.Pl	viscerum	um	um
viscus:Abl.Sg	viscere	e	e
viscus:Nom.Pl	viscera	a	a
viscus:Acc.Sg	viscus	NULL	NULL
viscus:Dat.Pl	visceribus	ibus	ibus
vita:Nom.Sg	vīta	a	a
vita:Abl.Pl	vītīs	īs	īs
vita:Dat.Sg	vītae	ae	ae
vita:Acc.Pl	vītās	ās	ās
vita:Gen.Sg	vītae	ae	a
vita:Gen.Pl	vītārum	ārum	ā
vita:Abl.Sg	vītā	ā	ā
vita:Nom.Pl	vītae	ae	a
vita:Acc.Sg	vītam	am	am
vita:Dat.Pl	vītīs	īs	īs
vitis:Nom.Sg	vītis	is	īs
vitis:Abl.Pl	vītibus	ibus	ibus
vitis:Dat.Sg	vītī	ī	ī
vitis:Acc.Pl	vītēs	ēs	ēs
vitis:Gen.Sg	vītis	is	is
vitis:Gen.Pl	vītium	ium	a
vitis:Abl.Sg	vīte	e	e
vitis:Nom.Pl	vītēs	ēs	ēs
vitis:Acc.Sg	vītem	em	em
vitis:Dat.Pl	vītibus	ibus	ibus
vitium:Nom.Sg	vitium	um	um
vitium:Abl.Pl	vitiīs	īs	īs
vitium:Dat.Sg	vitiō	ō	ō
vitium:Acc.Pl	vitia	a	a
vitium:Gen.Sg	vitiī	ī	ī
vitium:Gen.Pl	vitiōrum	ōrum	ēs
vitium:Abl.Sg	vitiō	ō	em
vitium:Nom.Pl	vitia	a	a
vitium:Acc.Sg	vitium	um	um
vitium:Dat.Pl	vitiīs	īs	īs
voluptas:Nom.Sg	voluptās	NULL	NULL
voluptas:Abl.Pl	voluptātibus	ibus	ibus
voluptas:Dat.Sg	voluptātī	ī	ī
voluptas:Acc.Pl	voluptātēs	ēs	ēs
voluptas:Gen.Sg	voluptātis	is	ae
voluptas:Gen.Pl	voluptātum	um	um
voluptas:Abl.Sg	voluptāte	e	e
voluptas:Nom.Pl	voluptātēs	ēs	ēs
voluptas:Acc.Sg	voluptātem	em	em
voluptas:Dat.Pl	voluptātibus	ibus	ibus
votum:Nom.Sg	vōtum	um	um
votum:Abl.Pl	vōtīs	īs	īs
votum:Dat.Sg	vōtō	ō	ō
votum:Acc.Pl	vōta	a	a
votum:Gen.Sg	vōtī	ī	ī
votum:Gen.Pl	vōtōrum	ōrum	ēs
votum:Abl.Sg	vōtō	ō	ō
votum:Nom.Pl	vōta	a	a
votum:Acc.Sg	vōtum	um	um
votum:Dat.Pl	vōtīs	īs	īs
vox:Nom.Sg	vōx	NULL	NULL
vox:Abl.Pl	vōcibus	ibus	ibus
vox:Dat.Sg	vōcī	ī	ī
vox:Acc.Pl	vōcēs	ēs	ēs
vox:Gen.Sg	vōcis	is	is
vox:Gen.Pl	vōcum	um	um
vox:Abl.Sg	vōce	e	e
vox:Nom.Pl	vōcēs	ēs	ēs
vox:Acc.Sg	vōcem	em	em
vox:Dat.Pl	vōcibus	ibus	ibus
vulgus:Nom.Sg	vulgus	us	ī
vulgus:Abl.Pl	N/AN/A	N/A	N/A
vulgus:Dat.Sg	vulgō	ō	ēs
vulgus:Acc.Pl	N/AN/A	N/A	N/A
vulgus:Gen.Sg	vulgī	ī	um
vulgus:Gen.Pl	N/AN/A	N/A	a
vulgus:Abl.Sg	vulgō	ō	ēs
vulgus:Nom.Pl	N/AN/A	N/A	N/A
vulgus:Acc.Sg	vulgus	us	N/A
vulgus:Dat.Pl	N/AN/A	N/A	a
vulnus:Nom.Sg	vulnus	NULL	NULL
vulnus:Abl.Pl	vulneribus	ibus	ibus
vulnus:Dat.Sg	vulnerī	ī	ī
vulnus:Acc.Pl	vulnera	a	a
vulnus:Gen.Sg	vulneris	is	is
vulnus:Gen.Pl	vulnerum	um	um
vulnus:Abl.Sg	vulnere	e	e
vulnus:Nom.Pl	vulnera	a	a
vulnus:Acc.Sg	vulnus	NULL	NULL
vulnus:Dat.Pl	vulneribus	ibus	ibus
vultus:Nom.Sg	vultus	us	us
vultus:Abl.Pl	vultibus	ibus	ibus
vultus:Dat.Sg	vultuī	uī	um
vultus:Acc.Pl	vultūs	ūs	us
vultus:Gen.Sg	vultūs	ūs	ūs
vultus:Gen.Pl	vultuum	uum	ēs
vultus:Abl.Sg	vultū	ū	ū
vultus:Nom.Pl	vultūs	ūs	us
vultus:Acc.Sg	vultum	um	um
vultus:Dat.Pl	vultibus	ibus	ibus
